Rk ,Player ,Pos ,Age ,Tm ,G ,GS ,MP ,FG ,FGA ,FG% ,3P ,3PA ,3P% ,2P ,2PA ,2P% ,eFG% ,FT ,FTA ,FT% ,ORB ,DRB ,TRB ,AST ,STL ,BLK ,TOV ,PF ,PTS
1,Alex Abrines,SG,25,OKC,31,2,588,56,157,0.357,41,127,0.323,15,30,0.5,0.487,12,13,0.923,5,43,48,20,17,6,14,53,165
2,Quincy Acy,PF,28,PHO,10,0,123,4,18,0.222,2,15,0.133,2,3,0.667,0.278,7,10,0.7,3,22,25,8,1,4,4,24,17
3,Jaylen Adams,PG,22,ATL,32,0,393,36,103,0.35,24,71,0.338,12,32,0.375,0.466,6,8,0.75,11,42,53,61,13,5,26,41,102
4,Steven Adams,C,25,OKC,77,77,2593,473,788,0.6,0,2,0,473,786,0.602,0.6,142,284,0.5,379,360,739,122,116,75,132,196,1088
5,Bam Adebayo,C,21,MIA,79,26,1841,266,461,0.577,2,13,0.154,264,448,0.589,0.579,159,216,0.736,161,408,569,180,68,63,116,200,693
6,Deng Adel,SF,21,CLE,17,3,187,10,35,0.286,5,22,0.227,5,13,0.385,0.357,2,2,1,2,15,17,5,1,4,5,12,27
7,DeVaughn Akoon-Purcell,SG,25,DEN,7,0,22,3,10,0.3,0,4,0,3,6,0.5,0.3,1,2,0.5,1,3,4,6,2,0,2,4,7
8,LaMarcus Aldridge,C,33,SAS,79,79,2621,663,1284,0.516,10,40,0.25,653,1244,0.525,0.52,339,401,0.845,241,474,715,191,41,106,141,177,1675
9,Rawle Alkins,SG,21,CHI,7,0,68,8,25,0.32,2,9,0.222,6,16,0.375,0.36,5,7,0.714,9,10,19,9,1,0,5,4,23
10,Grayson Allen,SG,23,UTA,35,1,347,54,141,0.383,27,83,0.325,27,58,0.466,0.479,29,42,0.69,1,13,14,20,5,5,29,41,164
11,Jarrett Allen,C,20,BRK,77,77,2034,325,550,0.591,6,44,0.136,319,506,0.63,0.596,194,274,0.708,186,458,644,108,42,117,100,180,850
12,Kadeem Allen,SG,26,NYK,18,1,387,62,131,0.473,15,33,0.455,47,98,0.48,0.531,37,46,0.804,8,38,46,68,14,3,26,45,176
13,Al-Farouq Aminu,PF,28,POR,79,79,2246,249,576,0.432,95,273,0.348,154,303,0.508,0.515,144,166,0.867,109,485,594,104,67,32,71,142,737
14,Justin Anderson,SF,25,ATL,46,4,432,60,149,0.403,21,72,0.292,39,77,0.506,0.473,22,31,0.71,23,55,78,21,21,13,20,45,163
15,Kyle Anderson,SF,25,MEM,43,40,1281,150,276,0.543,9,34,0.265,141,242,0.583,0.56,37,64,0.578,48,203,251,128,54,37,58,112,346
16,Ryan Anderson,PF,30,TOT,24,8,321,21,69,0.304,9,40,0.225,12,29,0.414,0.37,12,16,0.75,18,36,54,19,4,1,14,25,63
16,Ryan Anderson,PF,30,PHO,15,8,278,19,60,0.317,7,34,0.206,12,26,0.462,0.375,11,14,0.786,14,31,45,17,3,1,12,23,56
16,Ryan Anderson,PF,30,MIA,9,0,43,2,9,0.222,2,6,0.333,0,3,0,0.333,1,2,0.5,4,5,9,2,1,0,2,2,7
17,Ike Anigbogu,C,20,IND,3,0,6,0,3,0,0,0,,0,3,0,0,0,0,,1,2,3,1,0,1,1,0,0
18,Giannis Antetokounmpo,PF,24,MIL,71,71,2334,711,1232,0.577,50,198,0.253,661,1034,0.639,0.597,492,674,0.73,156,733,889,421,91,107,267,232,1964
19,Kostas Antetokounmpo,PF,21,DAL,2,0,11,0,3,0,0,0,,0,3,0,0,2,4,0.5,0,1,1,0,2,0,1,0,2
20,Carmelo Anthony,PF,34,HOU,10,2,294,49,121,0.405,21,64,0.328,28,57,0.491,0.492,15,22,0.682,9,45,54,5,4,7,8,32,134
21,OG Anunoby,SF,21,TOR,65,6,1317,179,394,0.454,66,198,0.333,113,196,0.577,0.538,36,62,0.581,56,134,190,44,45,22,51,137,460
22,Ryan Arcidiacono,PG,24,CHI,78,30,1881,176,392,0.449,78,208,0.375,98,184,0.533,0.548,79,91,0.868,25,180,205,258,62,4,61,165,509
23,Trevor Ariza,SF,33,TOT,69,69,2349,294,736,0.399,145,434,0.334,149,302,0.493,0.498,130,164,0.793,50,321,371,252,91,21,106,130,863
23,Trevor Ariza,SF,33,PHO,26,26,884,86,227,0.379,50,139,0.36,36,88,0.409,0.489,36,43,0.837,16,129,145,87,38,8,39,44,258
23,Trevor Ariza,SF,33,WAS,43,43,1465,208,509,0.409,95,295,0.322,113,214,0.528,0.502,94,121,0.777,34,192,226,165,53,13,67,86,605
24,D.J. Augustin,PG,31,ORL,79,79,2206,307,653,0.47,127,302,0.421,180,351,0.513,0.567,178,205,0.868,40,152,192,412,51,4,123,111,919
25,Deandre Ayton,C,20,PHO,71,70,2183,509,870,0.585,0,4,0,509,866,0.588,0.585,141,189,0.746,223,506,729,125,61,67,126,209,1159
26,Dwayne Bacon,SG,23,CHO,40,10,667,103,223,0.462,33,76,0.434,70,147,0.476,0.536,33,45,0.733,8,78,86,43,10,5,17,64,272
27,Marvin Bagley,PF,19,SAC,60,4,1506,340,673,0.505,27,88,0.307,313,585,0.535,0.525,177,256,0.691,157,291,448,62,32,58,97,118,884
28,Ron Baker,SG,25,TOT,15,0,152,4,20,0.2,1,13,0.077,3,7,0.429,0.225,5,6,0.833,1,10,11,15,6,1,5,18,14
28,Ron Baker,SG,25,NYK,11,0,107,4,16,0.25,1,9,0.111,3,7,0.429,0.281,5,6,0.833,1,6,7,13,5,0,3,16,14
28,Ron Baker,SG,25,WAS,4,0,45,0,4,0,0,4,0,0,0,,0,0,0,,0,4,4,2,1,1,2,2,0
29,Wade Baldwin,PG,22,POR,16,0,94,10,33,0.303,2,9,0.222,8,24,0.333,0.333,8,11,0.727,2,13,15,12,1,2,14,11,30
30,Lonzo Ball,PG,21,LAL,47,45,1423,185,456,0.406,75,228,0.329,110,228,0.482,0.488,20,48,0.417,54,197,251,255,69,19,103,114,465
31,Mohamed Bamba,C,20,ORL,47,1,766,117,243,0.481,21,70,0.3,96,173,0.555,0.525,37,63,0.587,64,169,233,39,13,64,43,102,292
32,J.J. Barea,PG,34,DAL,38,0,752,161,385,0.418,38,128,0.297,123,257,0.479,0.468,55,78,0.705,13,82,95,211,22,1,72,50,415
33,Harrison Barnes,PF-SF,26,TOT,75,75,2480,419,1005,0.417,168,431,0.39,251,574,0.437,0.5,220,266,0.827,55,299,354,111,50,12,98,120,1226
33,Harrison Barnes,PF,26,DAL,49,49,1584,290,717,0.404,121,311,0.389,169,406,0.416,0.489,165,198,0.833,36,171,207,62,33,11,68,79,866
33,Harrison Barnes,SF,26,SAC,26,26,896,129,288,0.448,47,120,0.392,82,168,0.488,0.53,55,68,0.809,19,128,147,49,17,1,30,41,360
34,Will Barton,SG,28,DEN,40,35,1113,178,438,0.406,65,187,0.348,113,251,0.45,0.481,54,70,0.771,31,151,182,116,17,21,63,79,475
35,Keita Bates-Diop,SF,23,MIN,27,3,442,53,125,0.424,11,45,0.244,42,80,0.525,0.468,16,26,0.615,15,54,69,14,14,12,10,27,133
36,Nicolas Batum,SF,30,CHO,72,69,2284,252,557,0.452,115,294,0.391,137,263,0.521,0.556,77,89,0.865,70,307,377,239,71,42,115,137,696
37,Jerryd Bayless,PG,30,MIN,34,6,657,82,230,0.357,29,98,0.296,53,132,0.402,0.42,16,28,0.571,11,51,62,119,18,2,32,56,209
38,Aron Baynes,C,32,BOS,50,17,807,103,219,0.47,21,60,0.35,82,159,0.516,0.518,53,62,0.855,86,150,236,54,12,34,39,124,280
39,Kent Bazemore,SG,29,ATL,65,35,1601,272,669,0.407,91,287,0.317,181,382,0.474,0.475,125,171,0.731,37,220,257,148,89,42,119,165,760
40,Bradley Beal,SG,25,WAS,80,80,2988,753,1581,0.476,205,586,0.35,548,995,0.551,0.541,359,445,0.807,87,316,403,439,120,58,223,224,2070
41,Malik Beasley,SG,22,DEN,78,18,1807,331,700,0.473,155,386,0.402,176,314,0.561,0.584,53,60,0.883,33,162,195,94,52,9,53,113,870
42,Michael Beasley,PF,30,LAL,26,2,277,75,153,0.49,3,17,0.176,72,136,0.529,0.5,28,39,0.718,13,47,60,25,9,10,27,42,181
43,Marco Belinelli,SG,32,SAS,77,1,1784,284,681,0.417,147,392,0.375,137,289,0.474,0.525,112,124,0.903,16,180,196,130,35,8,71,119,827
44,Jordan Bell,C,24,GSW,65,2,739,87,175,0.497,0,2,0,87,173,0.503,0.497,22,37,0.595,49,120,169,70,20,49,38,77,196
45,DeAndre' Bembry,SG,24,ATL,80,15,1888,266,598,0.445,50,171,0.292,216,427,0.506,0.487,81,130,0.623,51,297,348,198,103,41,138,181,663
46,Dragan Bender,PF,21,PHO,44,25,754,77,171,0.45,20,93,0.215,57,78,0.731,0.509,25,42,0.595,30,134,164,50,16,21,33,83,199
47,Dairis Bertans,SG,29,NOP,10,0,120,10,35,0.286,8,27,0.296,2,8,0.25,0.4,0,0,,2,5,7,8,1,0,2,5,28
48,Davis Bertans,PF,26,SAS,74,12,1592,195,435,0.448,140,326,0.429,55,109,0.505,0.609,53,60,0.883,23,236,259,99,34,33,41,133,583
49,Patrick Beverley,PG,30,LAC,77,48,2115,189,468,0.404,108,275,0.393,81,193,0.42,0.519,96,123,0.78,76,306,382,294,66,43,84,261,582
50,Khem Birch,C,26,ORL,48,0,605,87,143,0.608,0,1,0,87,142,0.613,0.608,57,81,0.704,76,106,182,36,18,29,20,66,231
51,Bismack Biyombo,C,26,CHO,51,29,713,83,145,0.572,0,0,,83,145,0.572,0.572,53,81,0.654,75,152,227,28,11,41,31,97,219
52,Nemanja Bjelica,PF,30,SAC,75,68,1755,275,581,0.473,98,250,0.392,177,331,0.535,0.558,68,90,0.756,125,319,444,144,54,56,82,195,716
53,Antonio Blakeney,SG,22,CHI,56,3,815,163,390,0.418,36,90,0.4,127,300,0.423,0.464,49,74,0.662,7,98,105,39,11,9,35,40,411
54,Eric Bledsoe,PG,29,MIL,76,76,2215,454,944,0.481,119,366,0.325,335,578,0.58,0.544,173,229,0.755,79,274,353,414,112,28,160,152,1200
55,Jaron Blossomgame,SF,25,CLE,27,4,439,47,106,0.443,10,39,0.256,37,67,0.552,0.491,10,13,0.769,26,72,98,13,7,8,11,20,114
56,Bogdan Bogdanovic,SG,26,SAC,68,17,1891,350,832,0.421,127,352,0.361,223,480,0.465,0.497,132,160,0.825,39,198,237,265,70,15,115,141,959
57,Bojan Bogdanovic,SF,29,IND,80,80,2544,517,1040,0.497,162,382,0.424,355,658,0.54,0.575,245,303,0.809,33,296,329,159,68,1,133,138,1441
58,Andrew Bogut,C,34,GSW,9,4,109,17,34,0.5,0,0,,17,34,0.5,0.5,3,3,1,10,36,46,10,1,5,3,18,37
59,Jonah Bolden,PF,23,PHI,42,9,601,76,152,0.5,31,89,0.348,45,63,0.714,0.602,13,27,0.481,47,115,162,37,17,38,36,93,196
60,Isaac Bonga,PG,19,LAL,20,0,92,5,28,0.179,0,7,0,5,21,0.238,0.179,9,15,0.6,7,15,22,13,8,3,4,7,19
61,Devin Booker,SG,22,PHO,64,64,2242,586,1255,0.467,135,414,0.326,451,841,0.536,0.521,393,454,0.866,39,226,265,433,56,13,264,200,1700
62,Chris Boucher,PF,26,TOR,27,0,139,27,66,0.409,11,34,0.324,16,32,0.5,0.492,13,15,0.867,15,28,43,0,6,22,5,29,78
63,Avery Bradley,SG,28,TOT,63,63,1905,248,608,0.408,86,245,0.351,162,363,0.446,0.479,43,50,0.86,43,132,175,152,41,16,89,167,625
63,Avery Bradley,SG,28,LAC,49,49,1463,161,420,0.383,58,172,0.337,103,248,0.415,0.452,20,25,0.8,35,96,131,96,27,16,61,133,400
63,Avery Bradley,SG,28,MEM,14,14,442,87,188,0.463,28,73,0.384,59,115,0.513,0.537,23,25,0.92,8,36,44,56,14,0,28,34,225
64,Tony Bradley,C,21,UTA,2,0,12,1,4,0.25,0,0,,1,4,0.25,0.25,0,0,,2,3,5,0,0,0,1,2,2
65,Corey Brewer,SF,32,TOT,29,3,455,53,121,0.438,14,44,0.318,39,77,0.506,0.496,31,43,0.721,24,48,72,36,30,7,16,59,151
65,Corey Brewer,SF,32,PHI,7,3,140,20,49,0.408,4,14,0.286,16,35,0.457,0.449,9,13,0.692,4,13,17,10,12,2,8,16,53
65,Corey Brewer,SF,32,SAC,22,0,315,33,72,0.458,10,30,0.333,23,42,0.548,0.528,22,30,0.733,20,35,55,26,18,5,8,43,98
66,Mikal Bridges,SF,22,PHO,80,54,2338,231,544,0.425,102,306,0.333,129,238,0.542,0.518,91,113,0.805,54,203,257,171,126,38,70,198,655
67,Miles Bridges,SF,20,CHO,77,22,1592,219,480,0.456,59,187,0.316,160,293,0.546,0.518,54,72,0.75,62,244,306,83,52,42,48,110,551
68,Isaiah Briscoe,PG,22,ORL,39,0,559,55,138,0.399,11,34,0.324,44,104,0.423,0.438,15,26,0.577,5,69,74,87,11,2,31,66,136
69,Ryan Broekhoff,SG,28,DAL,39,0,409,54,115,0.47,35,84,0.417,19,31,0.613,0.622,13,17,0.765,7,52,59,20,4,4,12,32,156
70,Malcolm Brogdon,SG,26,MIL,64,64,1832,378,748,0.505,104,244,0.426,274,504,0.544,0.575,141,152,0.928,65,223,288,205,46,13,91,102,1001
71,Dillon Brooks,SF,23,MEM,18,0,330,49,122,0.402,15,40,0.375,34,82,0.415,0.463,22,30,0.733,9,22,31,16,10,4,19,50,135
72,MarShon Brooks,SG,30,MEM,29,0,387,76,169,0.45,15,54,0.278,61,115,0.53,0.494,23,33,0.697,12,33,45,25,9,4,21,33,190
73,Bruce Brown,SG,22,DET,71,53,1382,118,302,0.391,24,92,0.261,94,210,0.448,0.43,39,54,0.722,43,131,174,87,37,35,46,169,299
74,Jaylen Brown,SG,22,BOS,72,24,1869,357,771,0.463,92,269,0.342,265,502,0.528,0.523,130,196,0.663,64,245,309,97,65,32,96,182,936
75,Lorenzo Brown,PG,28,TOR,26,0,212,23,71,0.324,6,28,0.214,17,43,0.395,0.366,3,3,1,5,26,31,28,12,5,16,22,55
76,Sterling Brown,SG,23,MIL,55,5,955,135,290,0.466,52,140,0.371,83,150,0.553,0.555,22,32,0.688,27,143,170,76,25,8,40,81,344
77,Troy Brown,SF,19,WAS,50,8,674,89,214,0.416,20,62,0.323,69,152,0.454,0.463,32,47,0.681,33,100,133,73,20,5,27,53,230
78,Jalen Brunson,PG,22,DAL,70,36,1508,252,536,0.47,62,173,0.358,190,363,0.523,0.528,80,110,0.727,25,135,160,208,36,4,83,120,646
79,Thomas Bryant,C,21,WAS,70,51,1456,296,484,0.612,31,95,0.326,265,389,0.681,0.644,104,133,0.782,110,331,441,90,24,65,58,124,727
80,Reggie Bullock,SG,27,TOT,63,60,1879,245,594,0.412,148,393,0.377,97,201,0.483,0.537,73,85,0.859,22,151,173,129,40,12,65,109,711
80,Reggie Bullock,SG,27,DET,44,44,1355,182,441,0.413,114,294,0.388,68,147,0.463,0.542,56,64,0.875,20,103,123,109,24,5,54,79,534
80,Reggie Bullock,SG,27,LAL,19,16,524,63,153,0.412,34,99,0.343,29,54,0.537,0.523,17,21,0.81,2,48,50,20,16,7,11,30,177
81,Trey Burke,PG,26,TOT,55,8,1070,224,522,0.429,50,144,0.347,174,378,0.46,0.477,97,118,0.822,27,68,95,150,31,7,48,52,595
81,Trey Burke,PG,26,NYK,33,7,689,148,358,0.413,30,86,0.349,118,272,0.434,0.455,62,75,0.827,15,47,62,94,21,5,29,33,388
81,Trey Burke,PG,26,DAL,22,1,381,76,164,0.463,20,58,0.345,56,106,0.528,0.524,35,43,0.814,12,21,33,56,10,2,19,19,207
82,Alec Burks,SG,27,TOT,64,24,1375,192,474,0.405,61,168,0.363,131,306,0.428,0.469,116,141,0.823,30,205,235,128,39,21,65,91,561
82,Alec Burks,SG,27,UTA,17,0,269,47,114,0.412,16,43,0.372,31,71,0.437,0.482,33,38,0.868,2,25,27,20,6,4,15,22,143
82,Alec Burks,SG,27,CLE,34,24,979,136,340,0.4,45,119,0.378,91,221,0.412,0.466,79,98,0.806,26,160,186,98,25,16,46,62,396
82,Alec Burks,SG,27,SAC,13,0,127,9,20,0.45,0,6,0,9,14,0.643,0.45,4,5,0.8,2,20,22,10,8,1,4,7,22
83,Deonte Burton,SG,25,OKC,31,0,239,33,82,0.402,8,27,0.296,25,55,0.455,0.451,8,12,0.667,4,24,28,9,6,8,9,31,82
84,Jimmy Butler,SF-SG,29,TOT,64,64,2169,416,899,0.463,67,192,0.349,349,707,0.494,0.5,312,365,0.855,122,220,342,262,123,39,93,110,1211
84,Jimmy Butler,SG,29,MIN,10,10,361,74,157,0.471,17,45,0.378,57,112,0.509,0.525,48,61,0.787,16,36,52,43,24,10,14,18,213
84,Jimmy Butler,SF,29,PHI,54,54,1808,342,742,0.461,50,147,0.34,292,595,0.491,0.495,264,304,0.868,106,184,290,219,99,29,79,92,998
85,Bruno Caboclo,SF,23,MEM,31,16,703,78,188,0.415,40,111,0.36,38,77,0.494,0.521,37,45,0.822,38,96,134,42,12,30,33,71,233
86,Jose Calderon,PG,37,DET,48,0,628,45,119,0.378,14,56,0.25,31,63,0.492,0.437,9,11,0.818,11,49,60,115,16,3,35,63,113
87,Kentavious Caldwell-Pope,SG,25,LAL,80,21,1949,301,703,0.428,144,412,0.35,157,291,0.54,0.531,128,145,0.883,46,181,227,96,71,13,60,134,874
88,Isaiah Canaan,PG,27,TOT,30,16,629,64,164,0.39,34,96,0.354,30,68,0.441,0.494,19,24,0.792,6,52,58,84,14,2,35,52,181
88,Isaiah Canaan,PG,27,PHO,19,15,503,51,129,0.395,25,72,0.347,26,57,0.456,0.492,15,20,0.75,5,44,49,62,12,0,29,46,142
88,Isaiah Canaan,PG,27,MIN,7,1,95,11,29,0.379,7,19,0.368,4,10,0.4,0.5,4,4,1,0,5,5,19,2,1,4,4,33
88,Isaiah Canaan,PG,27,MIL,4,0,31,2,6,0.333,2,5,0.4,0,1,0,0.5,0,0,,1,3,4,3,0,1,2,2,6
89,Clint Capela,C,24,HOU,65,65,2187,459,713,0.644,0,0,,459,713,0.644,0.644,156,247,0.632,289,536,825,89,43,98,91,164,1074
90,DeMarre Carroll,PF,32,BRK,65,6,1661,223,560,0.398,106,303,0.35,117,257,0.455,0.493,184,242,0.76,67,272,339,83,30,10,72,112,736
91,Jevon Carter,PG,23,MEM,36,3,517,40,158,0.253,21,84,0.25,19,74,0.257,0.32,20,26,0.769,12,46,58,64,25,11,32,50,121
92,Vince Carter,SF,42,ATL,74,9,1287,195,454,0.43,123,306,0.402,72,148,0.486,0.565,43,61,0.705,30,155,185,85,44,25,47,135,556
93,Wendell Carter,C,19,CHI,44,44,1110,180,371,0.485,6,32,0.188,174,339,0.513,0.493,89,112,0.795,87,220,307,78,26,58,65,152,455
94,Michael Carter-Williams,PG,27,TOT,26,1,334,43,115,0.374,10,37,0.27,33,78,0.423,0.417,26,45,0.578,17,45,62,60,16,14,19,43,122
94,Michael Carter-Williams,PG,27,HOU,16,1,145,25,61,0.41,7,19,0.368,18,42,0.429,0.467,12,26,0.462,3,10,13,21,9,6,10,27,69
94,Michael Carter-Williams,PG,27,ORL,10,0,189,18,54,0.333,3,18,0.167,15,36,0.417,0.361,14,19,0.737,14,35,49,39,7,8,9,16,53
95,Alex Caruso,PG,24,LAL,23,2,448,64,137,0.467,24,45,0.533,40,92,0.435,0.555,47,58,0.81,18,42,60,53,22,8,30,46,199
96,Omri Casspi,SF,30,MEM,36,0,520,86,161,0.534,15,43,0.349,71,118,0.602,0.581,39,58,0.672,17,98,115,26,20,9,23,35,226
97,Willie Cauley-Stein,C,25,SAC,79,79,2176,406,731,0.555,1,2,0.5,405,729,0.556,0.556,135,248,0.544,176,490,666,192,95,50,84,223,948
98,Troy Caupain,PG,23,ORL,4,0,16,4,8,0.5,2,3,0.667,2,5,0.4,0.625,0,0,,1,2,3,4,1,0,0,0,10
99,Tyler Cavanaugh,PF,24,UTA,9,0,22,3,8,0.375,1,5,0.2,2,3,0.667,0.438,2,2,1,1,4,5,0,0,0,1,0,9
100,Tyson Chandler,C,36,TOT,55,6,875,61,99,0.616,0,1,0,61,98,0.622,0.616,51,87,0.586,92,215,307,37,21,23,42,110,173
100,Tyson Chandler,C,36,PHO,7,0,89,8,12,0.667,0,0,,8,12,0.667,0.667,10,18,0.556,7,32,39,6,2,1,7,21,26
100,Tyson Chandler,C,36,LAL,48,6,786,53,87,0.609,0,1,0,53,86,0.616,0.609,41,69,0.594,85,183,268,31,19,22,35,89,147
101,Wilson Chandler,PF-SF,31,TOT,49,32,1134,109,259,0.421,57,150,0.38,52,109,0.477,0.531,17,23,0.739,47,160,207,79,25,21,44,118,292
101,Wilson Chandler,PF,31,PHI,36,32,951,91,207,0.44,46,118,0.39,45,89,0.506,0.551,13,18,0.722,44,124,168,72,22,18,39,94,241
101,Wilson Chandler,SF,31,LAC,13,0,183,18,52,0.346,11,32,0.344,7,20,0.35,0.452,4,5,0.8,3,36,39,7,3,3,5,24,51
102,Joe Chealey,PG,23,CHO,1,0,8,1,3,0.333,0,0,,1,3,0.333,0.333,0,0,,0,0,0,1,0,0,0,1,2
103,Chris Chiozza,PG,23,HOU,6,0,27,2,7,0.286,2,4,0.5,0,3,0,0.429,0,0,,1,2,3,3,1,0,1,2,6
104,Marquese Chriss,PF,21,TOT,41,2,473,63,167,0.377,16,69,0.232,47,98,0.48,0.425,30,41,0.732,37,97,134,21,15,11,36,76,172
104,Marquese Chriss,PF,21,HOU,16,0,104,11,34,0.324,1,15,0.067,10,19,0.526,0.338,6,7,0.857,7,21,28,6,2,4,12,17,29
104,Marquese Chriss,PF,21,CLE,25,2,369,52,133,0.391,15,54,0.278,37,79,0.468,0.447,24,34,0.706,30,76,106,15,13,7,24,59,143
105,Gary Clark,PF,24,HOU,50,2,632,48,147,0.327,39,134,0.291,9,13,0.692,0.459,7,7,1,22,90,112,18,20,26,7,47,142
106,Ian Clark,SG,27,NOP,58,4,899,132,340,0.388,56,177,0.316,76,163,0.466,0.471,30,33,0.909,11,73,84,87,19,6,56,90,350
107,Jordan Clarkson,SG,26,CLE,79,0,2166,521,1159,0.45,142,437,0.325,379,722,0.525,0.511,162,191,0.848,80,188,268,193,57,13,130,110,1346
108,John Collins,PF,21,ATL,60,58,1793,457,816,0.56,54,156,0.346,403,660,0.611,0.593,200,262,0.763,210,360,570,115,22,38,117,197,1168
109,Zach Collins,C,21,POR,74,0,1311,181,385,0.47,39,118,0.331,142,267,0.532,0.521,92,124,0.742,103,209,312,69,24,62,72,169,493
110,Darren Collison,PG,31,IND,74,74,2104,305,644,0.474,79,189,0.418,226,455,0.497,0.535,154,186,0.828,36,193,229,449,107,9,122,133,843
111,Bonzie Colson,SF,23,MIL,6,1,49,6,22,0.273,2,11,0.182,4,11,0.364,0.318,4,4,1,6,13,19,3,1,1,1,3,18
112,Mike Conley,PG,31,MEM,70,70,2342,490,1120,0.438,155,426,0.364,335,694,0.483,0.507,343,406,0.845,40,199,239,449,94,22,130,123,1478
113,Pat Connaughton,SG,26,MIL,58,2,1188,149,326,0.457,61,188,0.324,88,138,0.638,0.551,29,39,0.744,56,185,241,115,29,24,30,76,388
114,Quinn Cook,PG,25,GSW,71,9,989,188,406,0.463,77,190,0.405,111,216,0.514,0.558,17,22,0.773,21,129,150,107,20,3,46,84,470
115,DeMarcus Cousins,C,28,GSW,28,28,713,167,338,0.494,23,83,0.277,144,255,0.565,0.528,98,132,0.742,42,184,226,97,37,43,65,103,455
116,Robert Covington,SF,28,TOT,35,35,1203,156,362,0.431,85,225,0.378,71,137,0.518,0.548,68,89,0.764,28,165,193,46,74,47,47,126,465
116,Robert Covington,SF,28,PHI,13,13,440,50,117,0.427,30,77,0.39,20,40,0.5,0.556,17,23,0.739,7,60,67,14,24,23,22,45,147
116,Robert Covington,SF,28,MIN,22,22,763,106,245,0.433,55,148,0.372,51,97,0.526,0.545,51,66,0.773,21,105,126,32,50,24,25,81,318
117,Allen Crabbe,SG,26,BRK,43,20,1133,137,373,0.367,98,259,0.378,39,114,0.342,0.499,41,56,0.732,16,132,148,46,23,13,46,102,413
118,Torrey Craig,SF,28,DEN,72,37,1446,154,352,0.438,56,181,0.309,98,171,0.573,0.517,46,66,0.697,87,169,256,67,37,45,43,167,410
119,Jamal Crawford,SG,38,PHO,62,0,1146,147,391,0.376,56,181,0.309,91,210,0.433,0.448,80,96,0.833,8,68,76,218,31,11,93,71,430
120,Mitch Creek,SF,26,BRK,4,0,36,5,10,0.5,0,1,0,5,9,0.556,0.5,5,7,0.714,5,5,10,5,1,0,0,3,15
121,Jae Crowder,SF,28,UTA,77,10,2102,307,773,0.397,167,508,0.329,140,265,0.528,0.505,135,189,0.714,60,308,368,128,64,28,82,166,916
122,Dante Cunningham,PF,31,SAS,63,21,923,75,156,0.481,30,64,0.469,45,92,0.489,0.577,14,18,0.778,48,139,187,50,27,13,22,71,194
123,Seth Curry,SG,28,POR,72,2,1349,200,443,0.451,107,239,0.448,93,204,0.456,0.572,44,52,0.846,27,89,116,65,33,11,58,96,551
124,Stephen Curry,PG,30,GSW,67,67,2292,619,1316,0.47,350,798,0.439,269,518,0.519,0.603,261,285,0.916,45,318,363,356,91,24,190,163,1849
125,Troy Daniels,SG,27,PHO,49,1,723,112,264,0.424,73,186,0.392,39,78,0.5,0.563,18,23,0.783,12,58,70,25,24,5,27,75,315
126,Anthony Davis,C,25,NOP,56,56,1850,530,1026,0.517,48,145,0.331,482,881,0.547,0.54,344,433,0.794,174,498,672,218,88,135,112,132,1452
127,Deyonta Davis,C,22,ATL,7,0,102,12,19,0.632,0,1,0,12,18,0.667,0.632,4,6,0.667,8,25,33,4,3,5,3,12,28
128,Ed Davis,C,29,BRK,78,1,1403,178,292,0.61,0,2,0,178,290,0.614,0.61,96,155,0.619,210,466,676,61,34,33,64,226,452
129,Tyler Davis,C,21,OKC,1,0,1,0,1,0,0,0,,0,1,0,0,0,0,,1,0,1,0,0,0,0,0,0
130,Dewayne Dedmon,C,29,ATL,64,52,1609,259,526,0.492,83,217,0.382,176,309,0.57,0.571,92,113,0.814,105,375,480,90,69,71,84,214,693
131,Sam Dekker,PF,24,TOT,45,5,733,115,236,0.487,17,53,0.321,98,183,0.536,0.523,28,46,0.609,47,90,137,44,35,7,22,44,275
131,Sam Dekker,PF,24,CLE,9,5,169,22,48,0.458,5,13,0.385,17,35,0.486,0.51,8,10,0.8,9,24,33,9,11,0,5,13,57
131,Sam Dekker,PF,24,WAS,36,0,564,93,188,0.495,12,40,0.3,81,148,0.547,0.527,20,36,0.556,38,66,104,35,24,7,17,31,218
132,Angel Delgado,C,24,LAC,2,0,15,1,5,0.2,0,0,,1,5,0.2,0.2,1,2,0.5,2,2,4,0,1,0,0,2,3
133,Matthew Dellavedova,PG,28,TOT,48,0,812,98,242,0.405,44,130,0.338,54,112,0.482,0.496,42,52,0.808,6,71,77,181,14,2,68,75,282
133,Matthew Dellavedova,PG,28,MIL,12,0,97,6,19,0.316,4,11,0.364,2,8,0.25,0.421,4,4,1,0,10,10,29,2,0,11,9,20
133,Matthew Dellavedova,PG,28,CLE,36,0,715,92,223,0.413,40,119,0.336,52,104,0.5,0.502,38,48,0.792,6,61,67,152,12,2,57,66,262
134,Luol Deng,SF,33,MIN,22,2,392,59,118,0.5,14,44,0.318,45,74,0.608,0.559,25,35,0.714,20,53,73,18,15,8,14,24,157
135,DeMar DeRozan,SG,29,SAS,75,75,2623,620,1289,0.481,7,44,0.159,613,1245,0.492,0.484,355,428,0.829,53,401,454,462,82,36,194,173,1602
136,Marcus Derrickson,PF,22,GSW,9,0,54,10,24,0.417,5,14,0.357,5,10,0.5,0.521,3,4,0.75,5,3,8,1,0,1,3,9,28
137,Cheick Diallo,PF,22,NOP,62,1,842,159,259,0.614,0,3,0,159,256,0.621,0.614,50,67,0.746,72,243,315,26,28,33,46,106,368
138,Hamidou Diallo,SG,20,OKC,51,3,526,75,165,0.455,4,24,0.167,71,141,0.504,0.467,36,59,0.61,38,59,97,17,21,10,23,77,190
139,Gorgui Dieng,C,29,MIN,73,0,953,172,340,0.506,16,51,0.314,156,289,0.54,0.529,81,98,0.827,74,215,289,63,44,40,49,125,441
140,Spencer Dinwiddie,PG,25,BRK,65,4,1834,357,805,0.443,120,353,0.34,237,452,0.524,0.518,279,348,0.802,25,136,161,299,39,17,146,179,1113
141,Donte DiVincenzo,SG,22,MIL,27,0,411,50,124,0.403,22,83,0.265,28,41,0.683,0.492,9,12,0.75,16,49,65,31,13,6,19,38,131
142,Luka Doncic,SG,19,DAL,71,71,2286,500,1172,0.427,166,509,0.326,334,663,0.504,0.497,339,477,0.711,83,464,547,418,74,25,243,136,1505
143,Tyler Dorsey,SG,22,TOT,45,8,604,90,225,0.4,36,111,0.324,54,114,0.474,0.48,35,57,0.614,22,80,102,47,13,2,21,49,251
143,Tyler Dorsey,SG,22,ATL,27,0,251,32,89,0.36,10,39,0.256,22,50,0.44,0.416,16,26,0.615,9,34,43,17,7,1,10,20,90
143,Tyler Dorsey,SG,22,MEM,18,8,353,58,136,0.426,26,72,0.361,32,64,0.5,0.522,19,31,0.613,13,46,59,30,6,1,11,29,161
144,Damyean Dotson,SG,24,NYK,70,37,1902,281,672,0.418,121,330,0.367,160,342,0.468,0.508,73,98,0.745,34,218,252,123,58,9,66,133,756
145,PJ Dozier,SG,22,BOS,5,0,14,3,7,0.429,1,2,0.5,2,5,0.4,0.5,0,0,,2,4,6,0,0,0,0,1,7
146,Goran Dragic,PG,32,MIA,33,19,911,173,408,0.424,55,157,0.35,118,251,0.47,0.491,78,99,0.788,17,84,101,155,27,5,67,77,479
147,Andre Drummond,C,25,DET,76,76,2539,539,1014,0.532,5,38,0.132,534,976,0.547,0.534,232,395,0.587,402,772,1174,107,129,132,167,260,1315
148,Jared Dudley,PF,33,BRK,57,25,1170,95,225,0.422,49,141,0.348,46,84,0.548,0.531,26,40,0.65,30,115,145,78,33,15,41,127,265
149,Kris Dunn,PG,24,CHI,46,44,1389,215,506,0.425,34,96,0.354,181,410,0.441,0.458,55,69,0.797,19,168,187,277,68,21,104,166,519
150,Kevin Durant,PF,30,GSW,76,76,2655,708,1366,0.518,136,384,0.354,572,982,0.582,0.568,438,495,0.885,33,460,493,444,56,83,224,153,1990
151,Trevon Duval,PG,20,MIL,3,0,6,2,3,0.667,1,1,1,1,2,0.5,0.833,0,0,,0,1,1,2,0,0,0,0,5
152,Vince Edwards,SF,22,HOU,2,0,16,1,4,0.25,1,4,0.25,0,0,,0.375,0,0,,1,1,2,0,0,0,0,0,3
153,Henry Ellenson,PF,22,TOT,16,0,206,30,76,0.395,12,30,0.4,18,46,0.391,0.474,15,19,0.789,4,50,54,14,7,0,9,19,87
153,Henry Ellenson,PF,22,DET,2,0,25,4,10,0.4,2,4,0.5,2,6,0.333,0.5,2,2,1,0,9,9,1,0,0,0,2,12
153,Henry Ellenson,PF,22,NYK,14,0,181,26,66,0.394,10,26,0.385,16,40,0.4,0.47,13,17,0.765,4,41,45,13,7,0,9,17,75
154,Wayne Ellington,SG,31,TOT,50,35,1209,175,428,0.409,131,349,0.375,44,79,0.557,0.562,31,41,0.756,13,87,100,66,50,6,36,88,512
154,Wayne Ellington,SG,31,MIA,25,12,533,69,184,0.375,57,155,0.368,12,29,0.414,0.53,14,16,0.875,6,41,47,29,24,3,14,40,209
154,Wayne Ellington,SG,31,DET,25,23,676,106,244,0.434,74,194,0.381,32,50,0.64,0.586,17,25,0.68,7,46,53,37,26,3,22,48,303
155,Joel Embiid,C,24,PHI,63,63,2127,571,1183,0.483,79,260,0.304,492,923,0.533,0.516,520,643,0.809,159,702,861,229,46,119,224,209,1741
156,James Ennis,SF,28,TOT,58,27,1230,138,294,0.469,55,156,0.353,83,138,0.601,0.563,58,81,0.716,60,122,182,41,41,23,34,150,389
156,James Ennis,SF,28,HOU,40,25,949,104,211,0.493,44,120,0.367,60,91,0.659,0.597,42,58,0.724,37,80,117,27,38,16,23,111,294
156,James Ennis,SF,28,PHI,18,2,281,34,83,0.41,11,36,0.306,23,47,0.489,0.476,16,23,0.696,23,42,65,14,3,7,11,39,95
157,Drew Eubanks,PF,21,SAS,22,0,111,15,25,0.6,0,0,,15,25,0.6,0.6,11,13,0.846,6,28,34,7,2,5,8,10,41
158,Jacob Evans,SG,21,GSW,28,0,142,10,36,0.278,1,8,0.125,9,28,0.321,0.292,0,1,0,4,13,17,17,2,1,7,23,21
159,Jawun Evans,PG,22,PHO,7,0,64,3,13,0.231,0,2,0,3,11,0.273,0.231,0,0,,1,11,12,10,3,0,6,8,6
160,Tyreke Evans,SG,29,IND,68,17,1376,248,646,0.384,72,208,0.346,176,438,0.402,0.44,111,155,0.716,33,166,199,161,58,18,115,113,679
161,Dante Exum,PG,23,UTA,42,1,664,101,241,0.419,18,62,0.29,83,179,0.464,0.456,68,86,0.791,16,52,68,110,14,5,52,69,288
162,Kenneth Faried,C,29,TOT,36,13,720,153,261,0.586,8,24,0.333,145,237,0.612,0.602,63,98,0.643,95,152,247,20,17,22,33,82,377
162,Kenneth Faried,C,29,BRK,12,0,118,25,42,0.595,1,5,0.2,24,37,0.649,0.607,10,16,0.625,15,29,44,2,2,4,6,8,61
162,Kenneth Faried,C,29,HOU,24,13,602,128,219,0.584,7,19,0.368,121,200,0.605,0.6,53,82,0.646,80,123,203,18,15,18,27,74,316
163,Derrick Favors,C,27,UTA,75,69,1744,356,607,0.586,17,77,0.221,339,530,0.64,0.6,152,225,0.676,204,349,553,88,55,106,81,160,881
164,Cristiano Felicio,C,26,CHI,57,0,684,91,167,0.545,0,4,0,91,163,0.558,0.545,47,66,0.712,74,128,202,33,10,7,31,61,229
165,Raymond Felton,PG,34,OKC,30,0,335,49,122,0.402,14,51,0.275,35,71,0.493,0.459,12,13,0.923,4,24,28,42,10,6,13,26,124
166,Terrance Ferguson,SG,20,OKC,71,71,1847,171,406,0.421,98,272,0.36,73,134,0.545,0.542,35,48,0.729,31,97,128,64,40,16,42,221,475
167,Yogi Ferrell,PG,25,SAC,69,3,1019,144,333,0.432,50,140,0.357,94,193,0.487,0.508,60,67,0.896,12,93,105,131,33,4,39,60,398
168,Dorian Finney-Smith,SF,25,DAL,78,26,1901,213,490,0.435,76,239,0.318,137,251,0.546,0.512,70,100,0.7,127,237,364,88,68,36,71,177,572
169,Bryn Forbes,SG,25,SAS,80,79,2236,353,772,0.457,170,402,0.423,183,370,0.495,0.567,68,77,0.883,17,212,229,169,44,4,79,156,944
170,Evan Fournier,SG,26,ORL,79,79,2486,454,1038,0.437,150,439,0.342,304,599,0.508,0.51,130,162,0.802,38,213,251,289,69,12,151,223,1188
171,De'Aaron Fox,PG,21,SAC,79,79,2494,487,1074,0.453,84,228,0.368,403,846,0.476,0.493,300,414,0.725,41,256,297,570,130,44,224,202,1358
172,Melvin Frazier,SG,22,ORL,10,0,44,7,21,0.333,0,6,0,7,15,0.467,0.333,1,4,0.25,3,2,5,1,1,0,1,6,15
173,Tim Frazier,PG,28,TOT,56,18,1030,99,227,0.436,31,92,0.337,68,135,0.504,0.504,35,45,0.778,38,116,154,233,27,4,69,106,264
173,Tim Frazier,PG,28,NOP,47,17,909,88,195,0.451,27,77,0.351,61,118,0.517,0.521,32,41,0.78,32,105,137,206,25,4,60,93,235
173,Tim Frazier,PG,28,MIL,9,1,121,11,32,0.344,4,15,0.267,7,17,0.412,0.406,3,4,0.75,6,11,17,27,2,0,9,13,29
174,Jimmer Fredette,SG,29,PHO,4,0,46,8,25,0.32,0,10,0,8,15,0.533,0.32,6,6,1,0,4,4,3,3,0,4,5,22
175,Channing Frye,C,35,CLE,34,5,318,38,105,0.362,29,72,0.403,9,33,0.273,0.5,9,12,0.75,4,44,48,19,6,5,10,42,114
176,Markelle Fultz,SG,20,PHI,19,15,427,65,155,0.419,4,14,0.286,61,141,0.433,0.432,21,37,0.568,26,44,70,59,17,5,25,52,155
177,Danilo Gallinari,SF,30,LAC,67,67,2035,404,873,0.463,161,371,0.434,243,502,0.484,0.555,364,402,0.905,53,360,413,173,48,23,99,128,1333
178,Langston Galloway,SG,27,DET,77,4,1684,222,564,0.394,132,365,0.362,90,199,0.452,0.511,79,94,0.84,46,117,163,83,35,7,24,132,655
179,Billy Garrett,SG,24,NYK,2,0,37,5,13,0.385,0,4,0,5,9,0.556,0.385,2,2,1,0,1,1,4,1,1,1,2,12
180,Marc Gasol,C,34,TOT,77,70,2379,385,861,0.447,97,269,0.361,288,592,0.486,0.503,187,245,0.763,78,533,611,341,83,86,153,211,1054
180,Marc Gasol,C,34,MEM,53,53,1788,303,683,0.444,76,221,0.344,227,462,0.491,0.499,152,201,0.756,56,399,455,248,60,63,119,147,834
180,Marc Gasol,C,34,TOR,24,17,591,82,178,0.461,21,48,0.438,61,130,0.469,0.52,35,44,0.795,22,134,156,93,23,23,34,64,220
181,Pau Gasol,C,38,TOT,30,6,360,42,94,0.447,6,13,0.462,36,81,0.444,0.479,28,40,0.7,22,115,137,52,5,15,16,29,118
181,Pau Gasol,C,38,SAS,27,6,330,41,88,0.466,5,10,0.5,36,78,0.462,0.494,27,38,0.711,22,105,127,50,5,14,14,28,114
181,Pau Gasol,C,38,MIL,3,0,30,1,6,0.167,1,3,0.333,0,3,0,0.25,1,2,0.5,0,10,10,2,0,1,2,1,4
182,Rudy Gay,PF,32,SAS,67,51,1797,370,730,0.507,74,181,0.409,296,549,0.539,0.558,117,142,0.824,62,392,454,178,53,34,106,155,931
183,Paul George,SF,28,OKC,75,75,2762,690,1567,0.44,284,730,0.389,406,837,0.485,0.531,441,527,0.837,103,509,612,309,163,34,203,205,2105
184,Taj Gibson,PF,33,MIN,70,57,1686,304,537,0.566,11,34,0.324,293,503,0.583,0.576,134,177,0.757,172,286,458,84,53,39,73,186,753
185,Harry Giles,PF,20,SAC,58,0,820,175,348,0.503,0,6,0,175,342,0.512,0.503,58,91,0.637,66,156,222,85,31,22,73,150,408
186,Shai Gilgeous-Alexander,PG,20,LAC,80,71,2121,333,700,0.476,51,138,0.37,282,562,0.502,0.512,152,190,0.8,57,172,229,264,93,45,140,171,869
187,Rudy Gobert,C,26,UTA,79,78,2506,461,689,0.669,0,0,,461,689,0.669,0.669,321,505,0.636,301,720,1021,158,65,183,128,227,1243
188,Brandon Goodwin,PG,23,DEN,16,0,57,6,23,0.261,2,6,0.333,4,17,0.235,0.304,9,11,0.818,1,2,3,14,0,0,3,7,23
189,Aaron Gordon,PF,23,ORL,76,76,2559,453,1015,0.446,120,340,0.353,333,675,0.493,0.505,179,247,0.725,124,436,560,284,56,54,158,168,1205
190,Eric Gordon,SG,30,HOU,66,51,2103,372,912,0.408,206,578,0.356,166,334,0.497,0.521,119,152,0.783,17,129,146,126,39,26,88,141,1069
191,Marcin Gortat,C,34,LAC,47,43,751,99,186,0.532,0,0,,99,186,0.532,0.532,35,48,0.729,67,194,261,65,6,24,50,92,233
192,Devonte' Graham,PG,23,CHO,43,3,621,69,200,0.345,32,112,0.286,37,88,0.42,0.425,33,44,0.75,9,46,55,114,22,2,28,46,203
193,Treveon Graham,SG,25,BRK,32,20,646,54,161,0.335,29,106,0.274,25,55,0.455,0.425,18,22,0.818,19,76,95,30,12,7,15,64,155
194,Jerami Grant,PF,24,OKC,77,74,2503,390,786,0.496,107,276,0.388,283,510,0.555,0.564,150,213,0.704,89,313,402,77,60,97,65,209,1037
195,Jerian Grant,PG,26,ORL,60,1,939,92,220,0.418,40,110,0.364,52,110,0.473,0.509,26,40,0.65,19,79,98,156,44,6,51,78,250
196,Donte Grantham,SF,23,OKC,3,0,2,0,2,0,0,2,0,0,0,,0,0,0,,0,0,0,0,0,0,0,0,0
197,Danny Green,SG,31,TOR,78,78,2156,284,612,0.464,192,423,0.454,92,189,0.487,0.621,33,40,0.825,60,252,312,120,72,50,73,170,793
198,Draymond Green,PF,28,GSW,64,64,2017,184,411,0.448,47,164,0.287,137,247,0.555,0.505,61,89,0.685,58,407,465,443,90,67,164,193,476
199,Gerald Green,SG,33,HOU,71,0,1446,225,563,0.4,151,427,0.354,74,136,0.544,0.534,57,68,0.838,30,150,180,40,32,27,55,124,658
200,JaMychal Green,PF,28,TOT,64,6,1345,226,467,0.484,68,171,0.398,158,296,0.534,0.557,78,98,0.796,104,303,407,49,45,33,86,188,598
200,JaMychal Green,PF,28,MEM,41,4,900,151,312,0.484,38,96,0.396,113,216,0.523,0.545,63,80,0.788,72,180,252,36,33,26,64,123,403
200,JaMychal Green,PF,28,LAC,23,2,445,75,155,0.484,30,75,0.4,45,80,0.563,0.581,15,18,0.833,32,123,155,13,12,7,22,65,195
201,Jeff Green,PF,32,WAS,75,44,2056,317,664,0.477,110,309,0.356,207,355,0.583,0.56,177,198,0.894,57,245,302,133,42,38,98,160,921
202,Blake Griffin,PF,29,DET,73,73,2571,612,1318,0.464,186,509,0.365,426,809,0.527,0.535,410,545,0.752,99,460,559,397,51,27,249,194,1820
203,Daniel Hamilton,SG,23,ATL,19,3,204,23,60,0.383,8,23,0.348,15,37,0.405,0.45,3,6,0.5,10,37,47,22,6,1,16,19,57
204,Dusty Hannahs,SG,25,MEM,2,0,26,3,12,0.25,0,5,0,3,7,0.429,0.25,2,2,1,0,1,1,5,1,0,1,1,8
205,Tim Hardaway,SG,26,TOT,65,63,2057,390,993,0.393,162,477,0.34,228,516,0.442,0.474,232,276,0.841,33,189,222,159,54,8,105,141,1174
205,Tim Hardaway,SG,26,NYK,46,46,1499,282,726,0.388,117,337,0.347,165,389,0.424,0.469,199,233,0.854,26,135,161,122,42,6,81,106,880
205,Tim Hardaway,SG,26,DAL,19,17,558,108,267,0.404,45,140,0.321,63,127,0.496,0.489,33,43,0.767,7,54,61,37,12,2,24,35,294
206,James Harden,PG,29,HOU,76,76,2801,822,1867,0.44,368,1007,0.365,454,860,0.528,0.539,737,838,0.879,65,429,494,574,155,57,377,237,2749
207,Maurice Harkless,SF,25,POR,58,51,1360,178,372,0.478,32,116,0.276,146,256,0.57,0.522,42,65,0.646,74,182,256,74,67,49,44,157,430
208,Montrezl Harrell,C,25,LAC,80,4,2106,531,864,0.615,3,17,0.176,528,847,0.623,0.616,261,404,0.646,181,345,526,154,69,108,128,250,1326
209,Devin Harris,PG,35,DAL,65,0,993,122,322,0.379,58,188,0.309,64,134,0.478,0.469,95,125,0.76,11,92,103,111,35,13,51,125,397
210,Gary Harris,SG,24,DEN,54,45,1555,250,599,0.417,80,234,0.342,170,365,0.466,0.484,110,136,0.809,39,116,155,123,51,18,65,105,690
211,Joe Harris,SG,27,BRK,74,74,2229,362,721,0.502,176,373,0.472,186,348,0.534,0.624,108,130,0.831,49,232,281,178,36,17,117,180,1008
212,Tobias Harris,PF,26,TOT,80,80,2795,602,1224,0.492,156,385,0.405,446,839,0.532,0.556,262,301,0.87,66,564,630,222,51,37,148,184,1622
212,Tobias Harris,PF,26,LAC,55,55,1903,424,855,0.496,112,258,0.434,312,597,0.523,0.561,192,219,0.877,37,395,432,150,40,24,109,123,1152
212,Tobias Harris,PF,26,PHI,25,25,892,178,369,0.482,44,127,0.346,134,242,0.554,0.542,70,82,0.854,29,169,198,72,11,13,39,61,470
213,Andrew Harrison,PG,24,TOT,17,0,187,16,53,0.302,5,25,0.2,11,28,0.393,0.349,17,18,0.944,6,14,20,24,4,2,12,34,54
213,Andrew Harrison,PG,24,MEM,1,0,5,1,2,0.5,0,1,0,1,1,1,0.5,0,0,,0,0,0,0,0,0,0,1,2
213,Andrew Harrison,PG,24,CLE,10,0,144,12,39,0.308,3,14,0.214,9,25,0.36,0.346,16,16,1,4,11,15,17,4,2,10,26,43
213,Andrew Harrison,PG,24,NOP,6,0,38,3,12,0.25,2,10,0.2,1,2,0.5,0.333,1,2,0.5,2,3,5,7,0,0,2,7,9
214,Shaquille Harrison,PG,25,CHI,70,8,1359,171,398,0.43,21,83,0.253,150,315,0.476,0.456,79,119,0.664,33,179,212,134,87,26,57,121,442
215,Josh Hart,SG,23,LAL,67,22,1715,189,464,0.407,92,274,0.336,97,190,0.511,0.506,55,80,0.688,35,213,248,93,64,40,58,147,525
216,Isaiah Hartenstein,PF,20,HOU,28,0,221,20,41,0.488,2,6,0.333,18,35,0.514,0.512,11,14,0.786,21,26,47,15,7,12,13,56,53
217,Udonis Haslem,C,38,MIA,8,0,35,3,9,0.333,0,4,0,3,5,0.6,0.333,0,0,,1,11,12,0,0,0,2,4,6
218,Gordon Hayward,PF,28,BOS,71,18,1825,288,621,0.464,77,229,0.336,211,392,0.538,0.526,156,187,0.834,51,266,317,240,61,23,104,103,809
219,John Henson,C,28,MIL,14,0,188,31,67,0.463,11,31,0.355,20,36,0.556,0.545,6,10,0.6,16,55,71,14,7,11,12,16,79
220,Juan Hernangomez,PF,23,DEN,68,25,1325,135,308,0.438,65,179,0.363,70,129,0.543,0.544,66,86,0.767,63,196,259,51,26,24,37,89,401
221,Willy Hernangomez,C,24,CHO,57,3,809,153,294,0.52,15,38,0.395,138,256,0.539,0.546,100,144,0.694,117,192,309,59,16,20,58,98,421
222,Mario Hezonja,SF,23,NYK,56,22,1150,179,440,0.407,39,145,0.269,140,295,0.475,0.451,84,110,0.764,26,204,230,79,52,8,77,105,481
223,Isaiah Hicks,PF,24,NYK,1,0,4,0,0,,0,0,,0,0,,,1,2,0.5,0,0,0,1,0,0,0,0,1
224,Buddy Hield,SG,26,SAC,80,80,2567,615,1339,0.459,273,636,0.429,342,703,0.486,0.561,171,193,0.886,103,301,404,197,57,33,142,200,1674
225,Haywood Highsmith,SF,22,PHI,3,0,15,2,5,0.4,1,3,0.333,1,2,0.5,0.5,0,0,,0,3,3,2,0,0,0,1,5
226,Nene Hilario,C,36,HOU,40,2,520,56,107,0.523,0,2,0,56,105,0.533,0.523,29,45,0.644,32,86,118,22,18,14,10,82,141
227,George Hill,PG,32,TOT,57,13,1238,162,355,0.456,44,139,0.317,118,216,0.546,0.518,63,75,0.84,37,103,140,130,50,8,47,98,431
227,George Hill,PG,32,CLE,13,13,344,55,107,0.514,13,28,0.464,42,79,0.532,0.575,17,20,0.85,12,15,27,36,12,1,20,35,140
227,George Hill,PG,32,MIL,44,0,894,107,248,0.431,31,111,0.279,76,137,0.555,0.494,46,55,0.836,25,88,113,94,38,7,27,63,291
228,Solomon Hill,SF,27,NOP,42,15,831,61,159,0.384,28,90,0.311,33,69,0.478,0.472,23,32,0.719,34,90,124,50,22,9,30,75,173
229,Aaron Holiday,PG,22,IND,48,0,600,98,244,0.402,40,118,0.339,58,126,0.46,0.484,39,47,0.83,5,61,66,78,19,13,37,63,275
230,Jrue Holiday,SG,28,NOP,67,67,2402,547,1159,0.472,118,363,0.325,429,796,0.539,0.523,208,271,0.768,75,259,334,518,109,54,210,148,1420
231,Justin Holiday,SG,29,TOT,79,74,2501,280,733,0.382,149,439,0.339,131,294,0.446,0.484,88,98,0.898,44,266,310,141,118,34,99,157,797
231,Justin Holiday,SG,29,CHI,38,38,1325,151,394,0.383,97,270,0.359,54,124,0.435,0.506,41,46,0.891,19,150,169,85,67,21,47,79,440
231,Justin Holiday,SG,29,MEM,41,36,1176,129,339,0.381,52,169,0.308,77,170,0.453,0.457,47,52,0.904,25,116,141,56,51,13,52,78,357
232,John Holland,SF,30,CLE,1,0,1,0,0,,0,0,,0,0,,,0,0,,0,0,0,0,0,0,0,0,0
233,Rondae Hollis-Jefferson,SF,24,BRK,58,21,1208,195,469,0.416,9,47,0.191,186,422,0.441,0.425,118,183,0.645,78,220,298,93,41,26,65,106,517
234,Richaun Holmes,C,25,PHO,70,4,1184,222,365,0.608,0,0,,222,365,0.608,0.608,128,175,0.731,115,216,331,60,42,79,52,194,572
235,Rodney Hood,SG,26,TOT,70,49,1846,288,658,0.438,83,232,0.358,205,426,0.481,0.501,135,152,0.888,24,128,152,122,59,11,52,144,794
235,Rodney Hood,SG,26,CLE,45,45,1234,194,454,0.427,55,152,0.362,139,302,0.46,0.488,104,114,0.912,18,94,112,92,38,5,36,101,547
235,Rodney Hood,SG,26,POR,25,4,612,94,204,0.461,28,80,0.35,66,124,0.532,0.529,31,38,0.816,6,34,40,30,21,6,16,43,247
236,Al Horford,C,32,BOS,67,67,1947,380,711,0.534,72,202,0.356,308,509,0.605,0.585,75,91,0.824,120,334,454,276,57,86,100,124,907
237,Danuel House,SF,25,HOU,37,13,933,113,241,0.469,71,170,0.418,42,71,0.592,0.616,56,71,0.789,25,107,132,38,19,10,35,75,353
238,Dwight Howard,C,33,WAS,9,9,230,43,69,0.623,0,0,,43,69,0.623,0.623,29,48,0.604,24,59,83,4,7,4,16,34,115
239,Kevin Huerter,SG,20,ATL,73,57,1993,265,639,0.415,130,344,0.378,135,295,0.458,0.516,41,56,0.732,58,178,236,205,64,24,105,148,701
240,Isaac Humphries,C,21,ATL,3,0,38,3,14,0.214,1,7,0.143,2,7,0.286,0.25,0,0,,2,4,6,0,1,0,0,4,7
241,Chandler Hutchison,SF,22,CHI,44,14,895,96,209,0.459,14,50,0.28,82,159,0.516,0.493,23,38,0.605,31,154,185,34,23,6,25,59,229
242,Serge Ibaka,C,29,TOR,73,51,1991,458,863,0.531,49,168,0.292,409,695,0.588,0.559,135,177,0.763,154,442,596,99,29,100,113,209,1100
243,Andre Iguodala,SF,35,GSW,67,13,1556,149,292,0.51,47,138,0.341,102,154,0.662,0.591,39,67,0.582,47,204,251,211,61,51,51,95,384
244,Ersan Ilyasova,PF,31,MIL,64,6,1164,161,361,0.446,57,152,0.375,104,209,0.498,0.525,55,66,0.833,93,190,283,51,31,20,45,162,434
245,Joe Ingles,PF,31,UTA,79,79,2484,350,780,0.449,183,465,0.394,167,315,0.53,0.566,84,119,0.706,33,285,318,446,94,20,186,174,967
246,Andre Ingram,SG,33,LAL,4,0,15,0,6,0,0,3,0,0,3,0,0,0,0,,1,1,2,0,1,0,1,0,0
247,Brandon Ingram,SF,21,LAL,52,52,1760,362,729,0.497,31,94,0.33,331,635,0.521,0.518,195,289,0.675,41,226,267,154,28,31,129,149,950
248,Kyrie Irving,PG,26,BOS,66,66,2179,595,1222,0.487,170,428,0.397,425,794,0.535,0.556,213,244,0.873,70,260,330,458,102,33,169,165,1573
249,Jonathan Isaac,PF,21,ORL,74,63,1974,260,607,0.428,84,263,0.319,176,344,0.512,0.498,110,135,0.815,99,309,408,80,58,97,75,143,714
250,Wesley Iwundu,SF,24,ORL,66,12,1191,109,265,0.411,28,76,0.368,81,189,0.429,0.464,84,103,0.816,37,145,182,68,26,20,43,121,330
251,Demetrius Jackson,PG,24,PHI,6,0,39,8,15,0.533,2,6,0.333,6,9,0.667,0.6,4,4,1,2,1,3,5,2,0,1,4,22
252,Frank Jackson,PG,20,NOP,61,16,1169,194,447,0.434,53,169,0.314,141,278,0.507,0.493,54,73,0.74,25,109,134,69,25,2,48,92,495
253,Jaren Jackson,PF,19,MEM,58,56,1515,298,589,0.506,51,142,0.359,247,447,0.553,0.549,151,197,0.766,73,199,272,64,52,82,98,220,798
254,Josh Jackson,SG,21,PHO,77,27,1915,336,809,0.415,70,213,0.329,266,596,0.446,0.459,139,206,0.675,64,266,330,177,72,54,169,203,881
255,Justin Jackson,SF,23,TOT,78,11,1539,201,460,0.437,81,235,0.345,120,225,0.533,0.525,60,77,0.779,41,168,209,93,31,14,27,94,543
255,Justin Jackson,SF,23,SAC,52,3,1083,125,295,0.424,55,159,0.346,70,136,0.515,0.517,41,50,0.82,25,121,146,68,23,13,22,67,346
255,Justin Jackson,SF,23,DAL,26,8,456,76,165,0.461,26,76,0.342,50,89,0.562,0.539,19,27,0.704,16,47,63,25,8,1,5,27,197
256,Reggie Jackson,PG,28,DET,79,79,2219,427,1008,0.424,167,455,0.367,260,553,0.47,0.506,197,229,0.86,43,164,207,329,54,8,144,203,1218
257,LeBron James,SF,34,LAL,55,55,1937,558,1095,0.51,111,327,0.339,447,768,0.582,0.56,278,418,0.665,57,408,465,454,72,33,197,94,1505
258,Amile Jefferson,PF,25,ORL,11,0,44,7,12,0.583,0,0,,7,12,0.583,0.583,7,8,0.875,4,10,14,2,2,3,0,5,21
259,John Jenkins,SG,27,TOT,23,0,263,30,84,0.357,15,46,0.326,15,38,0.395,0.446,13,15,0.867,3,21,24,18,0,2,8,5,88
259,John Jenkins,SG,27,WAS,4,0,14,2,2,1,2,2,1,0,0,,1.5,0,0,,0,1,1,1,0,0,0,0,6
259,John Jenkins,SG,27,NYK,19,0,249,28,82,0.341,13,44,0.295,15,38,0.395,0.421,13,15,0.867,3,20,23,17,0,2,8,5,82
260,Jonas Jerebko,PF,31,GSW,70,6,1174,155,338,0.459,67,180,0.372,88,158,0.557,0.558,64,80,0.8,70,211,281,90,25,17,42,132,441
261,Alize Johnson,PF,22,IND,13,0,39,2,11,0.182,1,2,0.5,1,9,0.111,0.227,1,4,0.25,1,7,8,0,0,1,0,5,6
262,Amir Johnson,C,31,PHI,49,6,487,73,143,0.51,11,37,0.297,62,106,0.585,0.549,27,36,0.75,41,90,131,57,15,11,45,94,184
263,B.J. Johnson,SF,23,ATL,6,0,43,8,16,0.5,3,6,0.5,5,10,0.5,0.594,2,2,1,2,6,8,0,2,0,2,3,21
264,James Johnson,PF,31,MIA,52,33,1102,157,366,0.429,49,144,0.34,108,222,0.486,0.496,45,64,0.703,21,146,167,124,33,26,67,108,408
265,Stanley Johnson,SF,22,TOT,66,7,1208,171,440,0.389,62,215,0.288,109,225,0.484,0.459,50,64,0.781,34,183,217,88,60,14,81,114,454
265,Stanley Johnson,SF,22,DET,48,7,961,133,349,0.381,51,181,0.282,82,168,0.488,0.454,41,51,0.804,25,150,175,60,48,13,55,92,358
265,Stanley Johnson,SF,22,NOP,18,0,247,38,91,0.418,11,34,0.324,27,57,0.474,0.478,9,13,0.692,9,33,42,28,12,1,26,22,96
266,Tyler Johnson,PG,26,TOT,57,22,1529,217,526,0.413,90,260,0.346,127,266,0.477,0.498,95,127,0.748,34,139,173,166,54,27,77,97,619
266,Tyler Johnson,PG,26,MIA,44,10,1123,171,401,0.426,72,204,0.353,99,197,0.503,0.516,61,88,0.693,19,102,121,112,40,21,63,72,475
266,Tyler Johnson,PG,26,PHO,13,12,406,46,125,0.368,18,56,0.321,28,69,0.406,0.44,34,39,0.872,15,37,52,54,14,6,14,25,144
267,Wesley Johnson,SF,31,TOT,38,13,534,45,128,0.352,25,76,0.329,20,52,0.385,0.449,13,19,0.684,12,60,72,23,14,12,18,63,128
267,Wesley Johnson,SF,31,NOP,26,13,377,35,88,0.398,19,50,0.38,16,38,0.421,0.506,6,9,0.667,10,44,54,16,12,7,12,45,95
267,Wesley Johnson,SF,31,WAS,12,0,157,10,40,0.25,6,26,0.231,4,14,0.286,0.325,7,10,0.7,2,16,18,7,2,5,6,18,33
268,Nikola Jokic,C,23,DEN,78,78,2451,602,1174,0.513,82,263,0.312,520,911,0.571,0.548,287,348,0.825,223,623,846,576,104,54,243,218,1573
269,Damian Jones,C,23,GSW,24,22,410,53,74,0.716,0,0,,53,74,0.716,0.716,24,37,0.649,31,44,75,28,12,25,16,63,130
270,Derrick Jones,SF,21,MIA,57,14,1088,153,312,0.49,28,90,0.311,125,222,0.563,0.535,68,113,0.602,94,139,233,36,46,41,42,119,402
271,Jalen Jones,SF,25,CLE,16,0,214,26,62,0.419,10,28,0.357,16,34,0.471,0.5,19,27,0.704,11,23,34,7,9,2,8,27,81
272,Jemerrio Jones,SF,23,LAL,4,0,59,5,15,0.333,0,5,0,5,10,0.5,0.333,1,2,0.5,7,11,18,5,4,2,3,5,11
273,Terrence Jones,PF,27,HOU,2,0,5,1,4,0.25,0,2,0,1,2,0.5,0.25,0,1,0,0,4,4,0,0,0,1,1,2
274,Tyus Jones,PG,22,MIN,65,20,1463,173,417,0.415,39,119,0.328,134,298,0.45,0.462,54,65,0.831,23,104,127,296,80,5,46,73,439
275,DeAndre Jordan,C,30,TOT,69,69,2047,286,446,0.641,0,0,,286,446,0.641,0.641,186,264,0.705,225,677,902,156,42,73,153,167,758
275,DeAndre Jordan,C,30,DAL,50,50,1554,208,323,0.644,0,0,,208,323,0.644,0.644,135,198,0.682,161,525,686,99,33,53,111,125,551
275,DeAndre Jordan,C,30,NYK,19,19,493,78,123,0.634,0,0,,78,123,0.634,0.634,51,66,0.773,64,152,216,57,9,20,42,42,207
276,Cory Joseph,PG,27,IND,80,9,2023,219,532,0.412,53,166,0.319,166,366,0.454,0.461,28,41,0.683,38,235,273,315,92,21,80,128,519
277,Frank Kaminsky,C,25,CHO,44,0,686,124,270,0.459,45,127,0.354,79,143,0.552,0.543,65,90,0.722,38,114,152,57,11,11,37,61,358
278,Enes Kanter,C,26,TOT,65,29,1576,362,657,0.551,9,33,0.273,353,624,0.566,0.558,149,189,0.788,244,386,630,113,30,26,112,160,882
278,Enes Kanter,C,26,NYK,44,23,1128,251,468,0.536,7,22,0.318,244,446,0.547,0.544,105,129,0.814,171,290,461,84,18,17,79,106,614
278,Enes Kanter,C,26,POR,21,6,448,111,189,0.587,2,11,0.182,109,178,0.612,0.593,44,60,0.733,73,96,169,29,12,9,33,54,268
279,Luke Kennard,SG,22,DET,60,10,1363,211,487,0.433,96,247,0.389,115,240,0.479,0.532,46,56,0.821,11,160,171,108,26,10,51,85,564
280,Michael Kidd-Gilchrist,PF,25,CHO,63,3,1178,158,332,0.476,16,47,0.34,142,285,0.498,0.5,95,123,0.772,88,158,246,61,32,39,43,156,427
281,George King,SF,25,PHO,1,0,6,0,0,,0,0,,0,0,,,0,0,,0,1,1,0,0,0,0,0,0
282,Maxi Kleber,PF,27,DAL,70,18,1482,174,385,0.452,76,217,0.35,98,168,0.583,0.551,57,72,0.792,89,230,319,69,36,77,52,140,481
283,Brandon Knight,PG,27,TOT,37,24,679,91,238,0.382,37,121,0.306,54,117,0.462,0.46,22,27,0.815,9,44,53,68,18,1,26,59,241
283,Brandon Knight,PG,27,HOU,12,0,118,11,47,0.234,5,32,0.156,6,15,0.4,0.287,9,11,0.818,1,8,9,9,2,0,5,14,36
283,Brandon Knight,PG,27,CLE,25,24,561,80,191,0.419,32,89,0.36,48,102,0.471,0.503,13,16,0.813,8,36,44,59,16,1,21,45,205
284,Kevin Knox,PF,19,NYK,72,54,2063,325,872,0.373,120,343,0.35,205,529,0.388,0.442,151,210,0.719,58,253,311,74,42,23,110,171,921
285,Furkan Korkmaz,SG,21,PHI,46,6,654,94,234,0.402,46,139,0.331,48,95,0.505,0.5,35,42,0.833,16,89,105,51,28,2,25,59,269
286,Luke Kornet,PF,23,NYK,43,15,681,94,249,0.378,62,170,0.365,32,79,0.405,0.502,37,44,0.841,23,90,113,47,26,32,24,38,287
287,Kyle Korver,SG-PF,37,TOT,70,0,1334,201,483,0.416,138,348,0.397,63,135,0.467,0.559,60,73,0.822,9,153,162,81,25,12,59,106,600
287,Kyle Korver,PF,37,CLE,16,0,251,35,76,0.461,25,54,0.463,10,22,0.455,0.625,13,16,0.813,0,29,29,17,3,2,17,22,108
287,Kyle Korver,SG,37,UTA,54,0,1083,166,407,0.408,113,294,0.384,53,113,0.469,0.547,47,57,0.825,9,124,133,64,22,10,42,84,492
288,Kosta Koufos,C,29,SAC,42,1,502,73,153,0.477,0,0,,73,153,0.477,0.477,10,24,0.417,52,125,177,36,15,18,27,68,156
289,Rodions Kurucs,SF,20,BRK,60,43,1226,191,410,0.466,54,163,0.331,137,247,0.555,0.532,68,87,0.782,49,176,225,47,39,25,75,141,504
290,Kyle Kuzma,PF,23,LAL,70,68,2314,496,1087,0.456,128,422,0.303,368,665,0.553,0.515,188,250,0.752,60,322,382,178,41,26,133,170,1308
291,Skal Labissiere,PF,22,TOT,21,0,136,14,32,0.438,4,11,0.364,10,21,0.476,0.5,6,13,0.462,5,23,28,10,3,5,9,24,38
291,Skal Labissiere,PF,22,SAC,13,0,113,13,30,0.433,4,11,0.364,9,19,0.474,0.5,6,11,0.545,4,20,24,6,2,3,7,21,36
291,Skal Labissiere,PF,22,POR,8,0,23,1,2,0.5,0,0,,1,2,0.5,0.5,0,2,0,1,3,4,4,1,2,2,3,2
292,Jeremy Lamb,SG,26,CHO,76,55,2163,411,946,0.434,107,315,0.34,304,631,0.482,0.491,217,244,0.889,64,353,417,162,83,31,78,137,1146
293,Zach LaVine,SG,23,CHI,63,62,2171,530,1135,0.467,120,321,0.374,410,814,0.504,0.52,312,375,0.832,40,254,294,283,60,26,215,140,1492
294,Jake Layman,SF,24,POR,68,32,1258,208,403,0.516,57,175,0.326,151,228,0.662,0.587,47,66,0.712,56,153,209,51,30,30,42,111,520
295,T.J. Leaf,PF,21,IND,56,0,469,84,160,0.525,8,29,0.276,76,131,0.58,0.55,15,26,0.577,38,75,113,22,7,17,12,32,191
296,Courtney Lee,SG,33,TOT,32,5,391,47,117,0.402,14,50,0.28,33,67,0.493,0.462,14,21,0.667,9,40,49,34,19,3,13,29,122
296,Courtney Lee,SG,33,NYK,12,2,160,21,47,0.447,5,16,0.313,16,31,0.516,0.5,9,14,0.643,6,21,27,16,8,2,5,13,56
296,Courtney Lee,SG,33,DAL,20,3,231,26,70,0.371,9,34,0.265,17,36,0.472,0.436,5,7,0.714,3,19,22,18,11,1,8,16,66
297,Damion Lee,SG,26,GSW,29,0,313,44,100,0.44,21,54,0.389,23,46,0.5,0.545,12,15,0.8,7,42,49,7,12,0,10,27,121
298,Walt Lemon,PG,26,CHI,3,2,91,22,43,0.512,0,1,0,22,42,0.524,0.512,5,8,0.625,1,8,9,19,9,1,5,7,49
299,Alex Len,C,25,ATL,75,29,1479,301,608,0.495,66,186,0.355,235,422,0.557,0.549,133,201,0.662,150,256,406,79,27,64,96,193,801
300,Kawhi Leonard,SF,27,TOR,58,58,1978,545,1096,0.497,105,287,0.366,440,809,0.544,0.545,359,419,0.857,78,351,429,194,104,23,119,85,1554
301,Meyers Leonard,C,26,POR,60,1,836,124,229,0.541,49,109,0.45,75,120,0.625,0.648,41,49,0.837,45,177,222,72,13,9,40,101,338
302,Jon Leuer,PF,29,DET,40,1,398,65,112,0.58,1,11,0.091,64,101,0.634,0.585,23,31,0.742,27,69,96,14,12,4,23,60,154
303,Caris LeVert,SF,24,BRK,37,24,989,187,450,0.416,43,145,0.297,144,305,0.472,0.463,78,112,0.696,32,109,141,144,40,13,65,71,495
304,Damian Lillard,PG,28,POR,78,78,2764,666,1498,0.445,229,622,0.368,437,876,0.499,0.521,456,501,0.91,66,295,361,538,85,33,208,147,2017
305,Jeremy Lin,PG,30,TOT,73,4,1417,236,533,0.443,55,183,0.301,181,350,0.517,0.494,172,206,0.835,21,154,175,226,46,13,121,142,699
305,Jeremy Lin,PG,30,ATL,51,1,1003,180,386,0.466,44,132,0.333,136,254,0.535,0.523,142,168,0.845,16,103,119,181,38,7,98,96,546
305,Jeremy Lin,PG,30,TOR,22,3,414,56,147,0.381,11,51,0.216,45,96,0.469,0.418,30,38,0.789,5,51,56,45,8,6,23,46,153
306,Shaun Livingston,PG,33,GSW,62,0,939,105,205,0.512,0,2,0,105,203,0.517,0.512,40,49,0.816,40,73,113,113,30,27,38,70,250
307,Zach Lofton,SG,26,DET,1,0,4,0,1,0,0,1,0,0,0,,0,0,0,,0,0,0,0,1,0,1,0,0
308,Kevon Looney,C,22,GSW,77,24,1439,205,327,0.627,1,10,0.1,204,317,0.644,0.628,65,105,0.619,187,217,404,116,43,53,51,207,476
309,Brook Lopez,C,30,MIL,79,79,2268,350,769,0.455,186,504,0.369,164,265,0.619,0.576,108,129,0.837,31,350,381,96,51,172,80,183,994
310,Robin Lopez,C,30,CHI,71,33,1524,289,507,0.57,6,26,0.231,283,481,0.588,0.576,88,121,0.727,135,141,276,85,11,76,95,122,672
311,Kevin Love,PF,30,CLE,21,21,585,107,279,0.384,52,144,0.361,55,135,0.407,0.477,103,114,0.904,33,202,235,46,5,5,42,54,369
312,Kyle Lowry,PG,32,TOR,64,64,2171,303,731,0.415,157,448,0.35,146,283,0.516,0.522,158,190,0.832,41,262,303,559,88,31,180,164,921
313,Jordan Loyd,PG,25,TOR,11,0,47,6,14,0.429,3,7,0.429,3,7,0.429,0.536,8,10,0.8,1,7,8,6,0,0,2,5,23
314,Kalin Lucas,PG,29,DET,1,0,6,0,1,0,0,1,0,0,0,,0,2,2,1,0,3,3,1,0,0,0,1,2
315,Timothe Luwawu-Cabarrot,SF,23,TOT,47,5,588,69,185,0.373,32,101,0.317,37,84,0.44,0.459,23,31,0.742,11,72,83,24,18,7,21,63,193
315,Timothe Luwawu-Cabarrot,SF,23,OKC,21,1,123,13,43,0.302,5,22,0.227,8,21,0.381,0.36,4,6,0.667,4,14,18,4,4,1,5,14,35
315,Timothe Luwawu-Cabarrot,SF,23,CHI,26,4,465,56,142,0.394,27,79,0.342,29,63,0.46,0.489,19,25,0.76,7,58,65,20,14,6,16,49,158
316,Tyler Lydon,PF,22,DEN,24,0,90,8,17,0.471,4,10,0.4,4,7,0.571,0.588,1,3,0.333,6,11,17,5,2,0,4,10,21
317,Trey Lyles,PF,23,DEN,63,1,1093,201,483,0.416,48,193,0.249,153,290,0.528,0.466,81,115,0.704,41,196,237,85,30,23,66,90,531
318,Scott Machado,PG,28,LAL,4,0,19,4,6,0.667,1,1,1,3,5,0.6,0.75,1,1,1,0,0,0,3,1,0,0,2,10
319,Shelvin Mack,PG,28,TOT,57,3,1246,163,403,0.404,46,130,0.354,117,273,0.429,0.462,58,84,0.69,18,86,104,183,47,4,66,84,430
319,Shelvin Mack,PG,28,MEM,53,3,1204,161,389,0.414,46,128,0.359,115,261,0.441,0.473,53,75,0.707,18,84,102,182,45,4,62,81,421
319,Shelvin Mack,PG,28,CHO,4,0,42,2,14,0.143,0,2,0,2,12,0.167,0.143,5,9,0.556,0,2,2,1,2,0,4,3,9
320,Daryl Macon,SG,23,DAL,7,0,57,7,20,0.35,3,7,0.429,4,13,0.308,0.425,0,0,,2,3,5,5,1,0,5,6,17
321,J.P. Macura,SG,23,CHO,1,0,14,2,8,0.25,0,4,0,2,4,0.5,0.25,0,0,,0,2,2,2,0,0,0,0,4
322,Ian Mahinmi,C,32,WAS,32,6,453,42,86,0.488,1,13,0.077,41,73,0.562,0.494,41,60,0.683,40,69,109,24,24,15,20,76,126
323,Thon Maker,C-PF,21,TOT,61,4,923,108,258,0.419,49,148,0.331,59,110,0.536,0.514,54,82,0.659,38,154,192,44,21,49,31,102,319
323,Thon Maker,C,21,MIL,35,0,409,59,134,0.44,26,78,0.333,33,56,0.589,0.537,20,37,0.541,17,79,96,18,10,18,9,55,164
323,Thon Maker,PF,21,DET,26,4,514,49,124,0.395,23,70,0.329,26,54,0.481,0.488,34,45,0.756,21,75,96,26,11,31,22,47,155
324,Boban Marjanovic,C,30,TOT,55,11,626,142,233,0.609,2,6,0.333,140,227,0.617,0.614,96,128,0.75,84,161,245,45,14,25,57,88,382
324,Boban Marjanovic,C,30,LAC,36,9,376,85,140,0.607,0,2,0,85,138,0.616,0.607,72,95,0.758,55,97,152,22,11,17,37,57,242
324,Boban Marjanovic,C,30,PHI,19,2,250,57,93,0.613,2,4,0.5,55,89,0.618,0.624,24,33,0.727,29,64,93,23,3,8,20,31,140
325,Lauri Markkanen,PF,21,CHI,52,51,1682,342,795,0.43,120,332,0.361,222,463,0.479,0.506,170,195,0.872,74,396,470,75,37,33,85,122,974
326,Jarell Martin,PF,24,ORL,40,1,306,42,99,0.424,20,53,0.377,22,46,0.478,0.525,9,11,0.818,11,59,70,17,3,8,11,48,113
327,Frank Mason,PG,24,SAC,37,0,418,65,156,0.417,12,58,0.207,53,98,0.541,0.455,38,55,0.691,4,37,41,83,16,4,34,33,180
328,Wesley Matthews,SF-SG,32,TOT,68,67,2067,278,695,0.4,149,400,0.373,129,295,0.437,0.507,132,163,0.81,32,137,169,160,53,17,90,158,837
328,Wesley Matthews,SF,32,DAL,44,44,1312,194,469,0.414,100,263,0.38,94,206,0.456,0.52,87,110,0.791,20,82,102,100,33,12,58,102,575
328,Wesley Matthews,SG,32,NYK,2,1,54,4,19,0.211,2,10,0.2,2,9,0.222,0.263,4,5,0.8,1,2,3,5,1,1,2,2,14
328,Wesley Matthews,SG,32,IND,22,22,701,80,207,0.386,47,127,0.37,33,80,0.413,0.5,41,48,0.854,11,53,64,55,19,4,30,54,248
329,Luc Mbah a Moute,PF,32,LAC,4,0,61,8,18,0.444,2,6,0.333,6,12,0.5,0.5,2,5,0.4,2,5,7,2,1,1,2,8,20
330,Tahjere McCall,SG,24,BRK,1,0,8,2,3,0.667,0,1,0,2,2,1,0.667,0,1,0,0,1,1,0,0,0,0,2,4
331,Patrick McCaw,SG,23,TOT,29,1,397,26,63,0.413,9,28,0.321,17,35,0.486,0.484,13,15,0.867,7,41,48,29,23,2,17,38,74
331,Patrick McCaw,SG,23,CLE,3,0,53,2,9,0.222,1,4,0.25,1,5,0.2,0.278,0,0,,0,3,3,2,2,0,3,1,5
331,Patrick McCaw,SG,23,TOR,26,1,344,24,54,0.444,8,24,0.333,16,30,0.533,0.519,13,15,0.867,7,38,45,27,21,2,14,37,69
332,CJ McCollum,SG,27,POR,68,68,2321,563,1217,0.463,165,434,0.38,398,783,0.508,0.53,157,189,0.831,60,215,275,198,54,27,104,166,1448
333,T.J. McConnell,PG,26,PHI,73,2,1402,207,397,0.521,14,42,0.333,193,355,0.544,0.539,28,35,0.8,27,139,166,251,76,16,87,102,456
334,Doug McDermott,SF,27,IND,75,0,1288,201,403,0.499,81,199,0.407,120,204,0.588,0.599,61,74,0.824,16,88,104,64,17,8,42,101,544
335,JaVale McGee,C,31,LAL,73,60,1625,385,619,0.622,1,10,0.1,384,609,0.631,0.623,93,146,0.637,191,363,554,48,46,145,103,199,864
336,Rodney McGruder,SG,27,MIA,65,45,1527,185,455,0.407,79,225,0.351,106,230,0.461,0.493,52,70,0.743,58,174,232,112,36,12,64,115,501
337,Alfonzo McKinnie,SF,26,GSW,69,4,941,127,262,0.485,39,111,0.351,88,151,0.583,0.559,24,43,0.558,80,155,235,29,16,14,29,128,317
338,Ben McLemore,SG,25,SAC,19,0,158,25,64,0.391,17,41,0.415,8,23,0.348,0.523,8,12,0.667,3,14,17,4,6,3,5,22,75
339,Jordan McRae,SG,27,WAS,27,0,333,61,130,0.469,10,35,0.286,51,95,0.537,0.508,28,35,0.8,6,34,40,30,13,7,15,26,160
340,Jodie Meeks,SG,31,TOR,7,0,86,18,34,0.529,7,15,0.467,11,19,0.579,0.632,1,1,1,1,10,11,7,1,1,1,4,44
341,Salah Mejri,C,32,DAL,34,4,352,47,95,0.495,9,25,0.36,38,70,0.543,0.542,17,28,0.607,33,82,115,31,9,20,20,52,120
342,De'Anthony Melton,PG,20,PHO,48,31,942,93,244,0.381,28,93,0.301,65,151,0.43,0.439,18,24,0.75,24,103,127,152,65,23,69,109,232
343,Chimezie Metu,PF,21,SAS,29,0,145,19,58,0.328,0,2,0,19,56,0.339,0.328,13,17,0.765,9,27,36,13,6,2,15,14,51
344,Khris Middleton,SF,27,MIL,74,74,2322,480,1097,0.438,172,452,0.381,308,645,0.478,0.516,209,251,0.833,50,401,451,320,78,6,169,167,1341
345,C.J. Miles,SF,31,TOT,53,1,856,112,311,0.36,67,203,0.33,45,108,0.417,0.468,48,58,0.828,13,82,95,36,26,15,30,79,339
345,C.J. Miles,SF,31,TOR,40,1,562,70,206,0.34,43,137,0.314,27,69,0.391,0.444,35,44,0.795,12,56,68,22,18,10,21,62,218
345,C.J. Miles,SF,31,MEM,13,0,294,42,105,0.4,24,66,0.364,18,39,0.462,0.514,13,14,0.929,1,26,27,14,8,5,9,17,121
346,Darius Miller,SF,28,NOP,69,15,1757,189,484,0.39,133,364,0.365,56,120,0.467,0.528,56,71,0.789,14,114,128,146,40,23,59,165,567
347,Malcolm Miller,SF,25,TOR,9,0,58,10,24,0.417,10,21,0.476,0,3,0,0.625,2,2,1,0,4,4,1,1,1,1,4,32
348,Patty Mills,PG,30,SAS,80,1,1867,276,649,0.425,155,395,0.392,121,254,0.476,0.545,86,101,0.851,24,154,178,236,48,10,91,126,793
349,Paul Millsap,PF,33,DEN,68,63,1841,318,651,0.488,56,154,0.364,262,497,0.527,0.531,177,243,0.728,151,342,493,137,83,53,92,178,869
350,Shake Milton,SG,22,PHI,17,0,200,28,64,0.438,11,33,0.333,17,31,0.548,0.523,4,5,0.8,7,16,23,13,5,5,5,22,71
351,Nikola Mirotic,PF,27,TOT,46,25,1245,238,542,0.439,116,318,0.365,122,224,0.545,0.546,105,124,0.847,60,279,339,55,31,34,48,107,697
351,Nikola Mirotic,PF,27,NOP,32,22,925,182,407,0.447,85,231,0.368,97,176,0.551,0.552,85,101,0.842,46,218,264,35,21,25,37,86,534
351,Nikola Mirotic,PF,27,MIL,14,3,320,56,135,0.415,31,87,0.356,25,48,0.521,0.53,20,23,0.87,14,61,75,20,10,9,11,21,163
352,Donovan Mitchell,SG,22,UTA,75,75,2525,642,1487,0.432,181,504,0.359,461,983,0.469,0.493,299,372,0.804,57,250,307,313,102,31,213,200,1764
353,Naz Mitrou-Long,SG,25,UTA,12,0,49,3,11,0.273,1,7,0.143,2,4,0.5,0.318,0,0,,0,2,2,6,0,0,4,5,7
354,Malik Monk,SG,20,CHO,70,0,1201,223,574,0.389,107,321,0.333,116,253,0.458,0.482,90,102,0.882,15,114,129,110,34,17,84,101,643
355,Greg Monroe,C,28,TOT,40,2,428,77,166,0.464,0,4,0,77,162,0.475,0.464,35,61,0.574,63,96,159,17,13,8,31,61,189
355,Greg Monroe,C,28,TOR,38,2,423,74,161,0.46,0,4,0,74,157,0.471,0.46,35,61,0.574,60,96,156,16,13,8,31,61,183
355,Greg Monroe,C,28,BOS,2,0,5,3,5,0.6,0,0,,3,5,0.6,0.6,0,0,,3,0,3,1,0,0,0,0,6
356,E'Twaun Moore,SG,29,NOP,53,36,1463,256,532,0.481,76,176,0.432,180,356,0.506,0.553,45,59,0.763,35,92,127,102,40,8,59,112,633
357,Eric Moreland,PF,27,TOT,4,0,36,3,6,0.5,1,1,1,2,5,0.4,0.583,0,0,,3,13,16,4,0,0,3,9,7
357,Eric Moreland,PF,27,PHO,1,0,5,0,0,,0,0,,0,0,,,0,0,,0,3,3,0,0,0,0,1,0
357,Eric Moreland,PF,27,TOR,3,0,31,3,6,0.5,1,1,1,2,5,0.4,0.583,0,0,,3,10,13,4,0,0,3,8,7
358,Jaylen Morris,SG,23,MIL,4,0,29,4,10,0.4,1,3,0.333,3,7,0.429,0.45,1,2,0.5,0,5,5,4,2,0,1,1,10
359,Marcus Morris,PF,29,BOS,74,53,2060,375,835,0.449,144,383,0.376,231,452,0.511,0.535,139,166,0.837,75,375,450,108,43,24,91,178,1033
360,Markieff Morris,PF,29,TOT,55,16,1208,191,460,0.415,64,194,0.33,127,266,0.477,0.485,70,90,0.778,55,187,242,75,36,22,53,166,516
360,Markieff Morris,PF,29,WAS,34,15,883,143,328,0.436,48,144,0.333,95,184,0.516,0.509,57,73,0.781,41,133,174,60,25,20,47,117,391
360,Markieff Morris,PF,29,OKC,21,1,325,48,132,0.364,16,50,0.32,32,82,0.39,0.424,13,17,0.765,14,54,68,15,11,2,6,49,125
361,Monte Morris,PG,23,DEN,79,5,1895,333,674,0.494,90,218,0.413,243,456,0.533,0.561,57,72,0.792,35,153,188,288,70,4,52,98,813
362,Donatas Motiejunas,F-C,28,SAS,1,0,4,1,4,0.25,0,0,,1,4,0.25,0.25,0,0,,1,0,1,0,0,1,1,1,2
363,Johnathan Motley,PF,23,LAC,21,0,144,35,67,0.522,0,3,0,35,64,0.547,0.522,23,38,0.605,16,29,45,10,4,3,15,25,93
364,Emmanuel Mudiay,PG,22,NYK,59,42,1607,330,740,0.446,69,210,0.329,261,530,0.492,0.493,144,186,0.774,33,163,196,228,43,19,140,103,873
365,Jamal Murray,PG,21,DEN,73,72,2382,498,1140,0.437,146,401,0.364,352,739,0.476,0.501,186,217,0.857,63,241,304,355,66,26,154,152,1328
366,Dzanan Musa,SG,19,BRK,8,0,34,8,20,0.4,0,9,0,8,11,0.727,0.4,0,2,0,1,3,4,1,2,0,4,1,16
367,Mike Muscala,PF,27,TOT,62,8,1232,133,341,0.39,81,243,0.333,52,98,0.531,0.509,70,85,0.824,53,178,231,74,22,37,45,127,417
367,Mike Muscala,PF,27,PHI,47,6,1041,109,278,0.392,68,199,0.342,41,79,0.519,0.514,63,77,0.818,51,149,200,62,18,27,43,112,349
367,Mike Muscala,PF,27,LAL,15,2,191,24,63,0.381,13,44,0.295,11,19,0.579,0.484,7,8,0.875,2,29,31,12,4,10,2,15,68
368,Sviatoslav Mykhailiuk,SF,21,TOT,42,0,440,46,140,0.329,29,89,0.326,17,51,0.333,0.432,12,20,0.6,9,27,36,37,14,1,21,25,133
368,Sviatoslav Mykhailiuk,SF,21,LAL,39,0,420,44,132,0.333,27,85,0.318,17,47,0.362,0.436,12,20,0.6,8,26,34,33,13,1,20,25,127
368,Sviatoslav Mykhailiuk,SF,21,DET,3,0,20,2,8,0.25,2,4,0.5,0,4,0,0.375,0,0,,1,1,2,4,1,0,1,0,6
369,Abdel Nader,SF,25,OKC,60,1,679,86,203,0.424,31,94,0.33,55,109,0.505,0.5,27,35,0.771,12,96,108,18,19,12,24,67,230
370,Larry Nance,C,26,CLE,65,28,1725,241,462,0.522,32,94,0.34,209,368,0.568,0.556,92,130,0.708,160,369,529,203,95,38,95,186,606
371,Shabazz Napier,PG,27,BRK,55,2,953,162,418,0.388,70,215,0.326,92,203,0.453,0.471,115,138,0.833,15,80,95,138,41,16,66,64,509
372,Raul Neto,PG,26,UTA,37,1,474,74,161,0.46,20,60,0.333,54,101,0.535,0.522,28,33,0.848,6,56,62,93,14,4,35,49,196
373,Georges Niang,PF,25,UTA,56,0,428,68,145,0.469,39,92,0.424,29,53,0.547,0.603,13,17,0.765,9,68,77,29,9,3,16,50,188
374,Joakim Noah,C,33,MEM,42,1,693,110,213,0.516,0,1,0,110,212,0.519,0.516,78,109,0.716,58,180,238,89,20,31,50,96,298
375,Nerlens Noel,C,24,OKC,74,2,1022,157,268,0.586,0,0,,157,268,0.586,0.586,52,77,0.675,123,195,318,42,65,92,45,162,366
376,Dirk Nowitzki,PF,40,DAL,48,17,719,115,319,0.361,57,183,0.311,58,136,0.426,0.45,34,45,0.756,4,131,135,30,8,16,16,71,321
377,Frank Ntilikina,PG,20,NYK,43,16,904,95,282,0.337,33,115,0.287,62,167,0.371,0.395,23,30,0.767,12,75,87,121,30,14,56,104,246
378,James Nunnally,SF,28,TOT,15,0,102,12,34,0.353,8,25,0.32,4,9,0.444,0.471,4,4,1,0,5,5,7,1,0,1,10,36
378,James Nunnally,SF,28,MIN,13,0,64,9,21,0.429,5,13,0.385,4,8,0.5,0.548,4,4,1,0,4,4,5,1,0,1,4,27
378,James Nunnally,SF,28,HOU,2,0,38,3,13,0.231,3,12,0.25,0,1,0,0.346,0,0,,0,1,1,2,0,0,0,6,9
379,Jusuf Nurkic,C,24,POR,72,72,1974,420,826,0.508,3,29,0.103,417,797,0.523,0.51,282,365,0.773,243,505,748,233,71,103,168,250,1125
380,David Nwaba,SG,26,CLE,49,14,951,125,255,0.49,24,74,0.324,101,181,0.558,0.537,58,85,0.682,41,115,156,53,34,17,26,100,332
381,Royce O'Neale,SF,25,UTA,79,13,1579,154,322,0.478,64,161,0.398,90,161,0.559,0.578,31,41,0.756,21,251,272,118,53,23,68,164,403
382,Kyle O'Quinn,C,28,IND,43,2,357,64,126,0.508,1,11,0.091,63,115,0.548,0.512,15,19,0.789,27,87,114,54,9,23,30,65,144
383,Semi Ojeleye,PF,24,BOS,55,2,556,60,141,0.426,26,82,0.317,34,59,0.576,0.518,23,35,0.657,22,60,82,20,9,4,19,42,169
384,Jahlil Okafor,C,23,NOP,57,22,862,187,324,0.577,0,3,0,187,321,0.583,0.577,57,85,0.671,75,182,257,36,13,38,48,93,431
385,Elie Okobo,PG,21,PHO,51,14,907,106,274,0.387,36,126,0.286,70,148,0.473,0.453,33,43,0.767,11,83,94,120,29,7,65,104,281
386,Josh Okogie,SG,20,MIN,71,49,1686,192,496,0.387,59,211,0.28,133,285,0.467,0.447,116,159,0.73,41,174,215,86,84,30,63,159,559
387,Victor Oladipo,SG,26,IND,36,36,1147,249,588,0.423,74,216,0.343,175,372,0.47,0.486,103,141,0.73,21,181,202,186,60,11,82,72,675
388,Kelly Olynyk,PF,27,MIA,76,33,1753,252,546,0.462,110,311,0.354,142,235,0.604,0.562,150,183,0.82,71,292,363,137,52,34,110,180,764
389,Cedi Osman,SF,23,CLE,74,73,2372,349,820,0.426,127,365,0.348,222,455,0.488,0.503,137,175,0.783,42,307,349,194,57,11,112,191,962
390,Kelly Oubre,SF,23,TOT,69,19,1935,375,842,0.445,108,338,0.32,267,504,0.53,0.51,189,244,0.775,71,254,325,84,84,59,103,181,1047
390,Kelly Oubre,SF,23,WAS,29,7,755,132,305,0.433,41,132,0.311,91,173,0.526,0.5,68,85,0.8,24,105,129,20,27,20,30,71,373
390,Kelly Oubre,SF,23,PHO,40,12,1180,243,537,0.453,67,206,0.325,176,331,0.532,0.515,121,159,0.761,47,149,196,64,57,39,73,110,674
391,Zaza Pachulia,C,34,DET,66,3,856,82,185,0.443,0,4,0,82,181,0.453,0.443,94,120,0.783,93,161,254,88,30,17,55,147,258
392,Jabari Parker,PF,23,TOT,64,17,1724,369,749,0.493,61,195,0.313,308,554,0.556,0.533,131,184,0.712,79,342,421,152,46,30,151,145,930
392,Jabari Parker,PF,23,CHI,39,17,1042,220,464,0.474,37,114,0.325,183,350,0.523,0.514,79,108,0.731,41,200,241,84,23,14,84,87,556
392,Jabari Parker,PF,23,WAS,25,0,682,149,285,0.523,24,81,0.296,125,204,0.613,0.565,52,76,0.684,38,142,180,68,23,16,67,58,374
393,Tony Parker,PG,36,CHO,56,0,1003,213,463,0.46,13,51,0.255,200,412,0.485,0.474,91,124,0.734,14,69,83,207,21,7,75,53,530
394,Chandler Parsons,SF,30,MEM,23,3,437,62,159,0.39,26,84,0.31,36,75,0.48,0.472,18,21,0.857,3,60,63,33,18,4,26,41,168
395,Patrick Patterson,PF,29,OKC,62,5,859,82,219,0.374,46,137,0.336,36,82,0.439,0.479,19,30,0.633,41,105,146,31,16,13,22,46,229
396,Justin Patton,C,21,PHI,3,0,21,2,7,0.286,0,2,0,2,5,0.4,0.286,1,2,0.5,2,4,6,3,2,0,0,5,5
397,Chris Paul,PG,33,HOU,56,56,1797,291,697,0.418,120,341,0.352,171,356,0.48,0.504,174,202,0.861,35,220,255,458,107,18,148,143,876
398,Cameron Payne,PG,24,TOT,40,13,712,96,223,0.43,25,84,0.298,71,139,0.511,0.487,33,41,0.805,13,59,72,106,28,9,45,64,250
398,Cameron Payne,PG,24,CHI,31,12,536,69,168,0.411,16,59,0.271,53,109,0.486,0.458,22,25,0.88,10,43,53,83,20,6,34,49,176
398,Cameron Payne,PG,24,CLE,9,1,176,27,55,0.491,9,25,0.36,18,30,0.6,0.573,11,16,0.688,3,16,19,23,8,3,11,15,74
399,Elfrid Payton,PG,24,NOP,40,40,1185,168,389,0.432,31,97,0.32,137,292,0.469,0.472,50,67,0.746,48,160,208,299,43,13,104,80,417
400,Gary Payton,PG,26,WAS,3,0,16,5,8,0.625,1,2,0.5,4,6,0.667,0.688,0,0,,1,1,2,4,3,1,1,2,11
401,Theo Pinson,SG,23,BRK,17,0,192,23,66,0.348,12,42,0.286,11,24,0.458,0.439,19,22,0.864,2,30,32,19,5,0,15,13,77
402,Mason Plumlee,C,28,DEN,79,16,1650,252,421,0.599,2,10,0.2,250,411,0.608,0.601,109,193,0.565,160,339,499,227,63,72,124,242,615
403,Miles Plumlee,C,30,ATL,18,0,173,32,48,0.667,0,0,,32,48,0.667,0.667,16,30,0.533,16,23,39,17,6,4,10,14,80
404,Jakob Poeltl,C,23,SAS,75,22,1227,181,282,0.642,0,0,,181,282,0.642,0.642,49,92,0.533,174,224,398,91,27,65,47,121,411
405,Quincy Pondexter,SF,30,SAS,51,0,284,27,56,0.482,6,18,0.333,21,38,0.553,0.536,32,40,0.8,8,37,45,24,9,1,12,24,92
406,Otto Porter,SF,25,TOT,56,43,1683,299,643,0.465,104,256,0.406,195,387,0.504,0.546,78,96,0.813,54,260,314,120,82,31,65,108,780
406,Otto Porter,SF,25,WAS,41,28,1191,202,442,0.457,65,176,0.369,137,266,0.515,0.531,49,64,0.766,40,191,231,80,64,22,40,79,518
406,Otto Porter,SF,25,CHI,15,15,492,97,201,0.483,39,80,0.488,58,121,0.479,0.58,29,32,0.906,14,69,83,40,18,9,25,29,262
407,Bobby Portis,PF,23,TOT,48,26,1252,271,605,0.448,72,183,0.393,199,422,0.472,0.507,74,94,0.787,102,283,385,68,34,20,71,141,688
407,Bobby Portis,PF,23,CHI,22,6,531,122,271,0.45,27,72,0.375,95,199,0.477,0.5,39,50,0.78,46,115,161,29,11,8,29,61,310
407,Bobby Portis,PF,23,WAS,26,20,721,149,334,0.446,45,111,0.405,104,223,0.466,0.513,35,44,0.795,56,168,224,39,23,12,42,80,378
408,Dwight Powell,C,27,DAL,74,19,1581,279,468,0.596,39,124,0.315,240,344,0.698,0.638,185,239,0.774,129,256,385,106,43,47,64,190,782
409,Norman Powell,SG,25,TOR,58,3,1085,182,383,0.475,62,162,0.383,120,221,0.543,0.556,57,69,0.826,16,115,131,88,37,13,64,91,483
410,Alex Poythress,PF,25,ATL,21,1,305,40,81,0.494,9,23,0.391,31,58,0.534,0.549,18,29,0.621,29,47,76,17,4,10,13,47,107
411,Zhou Qi,PF,23,HOU,1,0,1,1,1,1,0,0,,1,1,1,1,0,0,,0,0,0,0,0,0,0,0,2
412,Ivan Rabb,PF,21,MEM,46,11,636,105,189,0.556,3,13,0.231,102,176,0.58,0.563,42,59,0.712,66,118,184,43,15,14,31,80,255
413,Chasson Randle,PG,25,WAS,47,2,693,85,199,0.427,41,101,0.406,44,98,0.449,0.53,40,58,0.69,10,43,53,89,23,3,41,86,251
414,Julius Randle,PF,24,NOP,73,49,2232,571,1089,0.524,67,195,0.344,504,894,0.564,0.555,356,487,0.731,162,472,634,229,52,45,208,246,1565
415,J.J. Redick,SG,34,PHI,75,62,2355,444,1015,0.437,236,598,0.395,208,417,0.499,0.554,225,252,0.893,20,161,181,205,31,17,100,128,1349
416,Davon Reed,SG,23,IND,8,0,22,2,4,0.5,1,1,1,1,3,0.333,0.625,0,0,,1,1,2,2,0,0,1,1,5
417,Cameron Reynolds,SG,23,MIN,16,0,207,23,57,0.404,14,37,0.378,9,20,0.45,0.526,8,9,0.889,4,19,23,10,5,2,2,19,68
418,Josh Richardson,SG,25,MIA,73,73,2539,423,1026,0.412,164,460,0.357,259,566,0.458,0.492,199,231,0.861,54,209,263,298,79,34,113,200,1209
419,Malachi Richardson,SG,23,TOR,22,0,103,9,29,0.31,8,25,0.32,1,4,0.25,0.448,4,5,0.8,2,11,13,0,1,0,8,13,30
420,Austin Rivers,SG,26,TOT,74,15,1984,227,559,0.406,101,318,0.318,126,241,0.523,0.496,50,94,0.532,25,134,159,161,45,23,68,205,605
420,Austin Rivers,SG,26,WAS,29,2,683,76,194,0.392,33,106,0.311,43,88,0.489,0.477,25,46,0.543,10,61,71,58,18,10,36,72,210
420,Austin Rivers,SG,26,HOU,45,13,1301,151,365,0.414,68,212,0.321,83,153,0.542,0.507,25,48,0.521,15,73,88,103,27,13,32,133,395
421,Devin Robinson,SF,23,WAS,5,0,46,9,15,0.6,0,0,,9,15,0.6,0.6,5,8,0.625,3,9,12,3,3,3,0,5,23
422,Duncan Robinson,PF,24,MIA,13,1,114,11,32,0.344,7,26,0.269,4,6,0.667,0.453,2,3,0.667,0,13,13,2,3,0,2,8,31
423,Glenn Robinson,SF,25,DET,45,18,568,70,167,0.419,17,59,0.288,53,108,0.491,0.47,31,38,0.816,17,44,61,19,12,7,18,43,188
424,Jerome Robinson,SG,21,LAC,31,0,291,37,98,0.378,16,53,0.302,21,45,0.467,0.459,5,7,0.714,3,30,33,14,10,3,9,42,95
425,Mitchell Robinson,C,20,NYK,63,16,1264,190,274,0.693,0,0,,190,274,0.693,0.693,75,128,0.586,171,222,393,37,51,155,33,206,455
426,Rajon Rondo,PG,32,LAL,46,29,1369,175,432,0.405,51,142,0.359,124,290,0.428,0.464,23,36,0.639,34,209,243,367,57,7,127,100,424
427,Derrick Rose,PG,30,MIN,51,13,1392,363,753,0.482,54,146,0.37,309,607,0.509,0.518,137,160,0.856,33,107,140,220,31,12,82,57,917
428,Terrence Ross,SG,27,ORL,79,0,2094,422,995,0.424,206,545,0.378,216,450,0.48,0.528,112,130,0.862,25,246,271,130,71,28,88,118,1162
429,Terry Rozier,PG,24,BOS,77,13,1746,247,645,0.383,114,326,0.35,133,319,0.417,0.471,72,91,0.791,32,266,298,225,67,21,64,99,680
430,Ricky Rubio,PG,28,UTA,68,67,1899,295,730,0.404,79,254,0.311,216,476,0.454,0.458,195,228,0.855,33,210,243,416,91,10,180,180,864
431,D'Angelo Russell,PG,22,BRK,78,78,2366,635,1474,0.431,223,616,0.362,412,858,0.48,0.506,153,197,0.777,48,252,300,542,97,19,246,137,1646
432,Domantas Sabonis,C,22,IND,73,5,1808,405,688,0.589,9,17,0.529,396,671,0.59,0.595,207,289,0.716,185,493,678,209,48,30,157,236,1026
433,Brandon Sampson,SG,21,CHI,11,2,143,18,40,0.45,5,20,0.25,13,20,0.65,0.513,3,4,0.75,1,10,11,7,4,2,10,12,44
434,JaKarr Sampson,SF,25,CHI,2,0,59,14,21,0.667,3,4,0.75,11,17,0.647,0.738,9,10,0.9,3,13,16,2,3,1,3,6,40
435,Dario Saric,PF,24,TOT,78,38,1937,286,656,0.436,111,303,0.366,175,353,0.496,0.521,126,144,0.875,122,316,438,123,45,8,94,174,809
435,Dario Saric,PF,24,PHI,13,13,396,48,132,0.364,21,70,0.3,27,62,0.435,0.443,27,30,0.9,21,65,86,26,4,3,25,39,144
435,Dario Saric,PF,24,MIN,65,25,1541,238,524,0.454,90,233,0.386,148,291,0.509,0.54,99,114,0.868,101,251,352,97,41,5,69,135,665
436,Tomas Satoransky,PG,27,WAS,78,52,2104,248,515,0.482,61,157,0.389,187,358,0.522,0.541,126,153,0.824,79,191,270,387,80,13,116,171,683
437,Dennis Schroder,PG,25,OKC,76,13,2213,436,1060,0.411,113,342,0.33,323,718,0.45,0.465,176,217,0.811,36,236,272,318,60,12,165,179,1161
438,Mike Scott,PF,30,TOT,77,1,1350,164,411,0.399,99,248,0.399,65,163,0.399,0.519,22,33,0.667,42,220,262,64,26,12,44,154,449
438,Mike Scott,PF,30,LAC,52,0,748,92,230,0.4,52,133,0.391,40,97,0.412,0.513,12,18,0.667,24,150,174,44,17,8,27,88,248
438,Mike Scott,PF,30,PHI,25,1,602,72,181,0.398,47,115,0.409,25,66,0.379,0.528,10,15,0.667,18,70,88,20,9,4,17,66,201
439,Thabo Sefolosha,SF,34,UTA,47,1,545,62,130,0.477,30,70,0.429,32,60,0.533,0.592,14,22,0.636,6,105,111,22,36,5,23,40,168
440,Wayne Selden,SG,24,TOT,72,10,1378,188,460,0.409,53,165,0.321,135,295,0.458,0.466,67,90,0.744,36,128,164,101,33,13,76,127,496
440,Wayne Selden,SG,24,MEM,32,0,455,65,161,0.404,20,63,0.317,45,98,0.459,0.466,22,29,0.759,16,28,44,36,10,6,23,48,172
440,Wayne Selden,SG,24,CHI,40,10,923,123,299,0.411,33,102,0.324,90,197,0.457,0.467,45,61,0.738,20,100,120,65,23,7,53,79,324
441,Collin Sexton,PG,20,CLE,80,70,2527,505,1174,0.43,116,282,0.411,389,892,0.436,0.48,211,251,0.841,57,178,235,229,43,6,178,183,1337
442,Landry Shamet,SG,21,TOT,77,25,1742,230,537,0.428,159,382,0.416,71,155,0.458,0.576,72,87,0.828,20,107,127,110,37,9,42,151,691
442,Landry Shamet,SG,21,PHI,54,4,1108,153,347,0.441,99,245,0.404,54,102,0.529,0.584,44,54,0.815,14,64,78,59,24,8,26,106,449
442,Landry Shamet,SG,21,LAC,23,21,634,77,190,0.405,60,137,0.438,17,53,0.321,0.563,28,33,0.848,6,43,49,51,13,1,16,45,242
443,Iman Shumpert,SG,28,TOT,61,41,1461,165,441,0.374,94,270,0.348,71,171,0.415,0.481,36,45,0.8,27,155,182,112,59,24,50,126,460
443,Iman Shumpert,SG,28,SAC,42,40,1099,133,348,0.382,74,202,0.366,59,146,0.404,0.489,34,41,0.829,19,110,129,91,47,20,38,92,374
443,Iman Shumpert,SG,28,HOU,19,1,362,32,93,0.344,20,68,0.294,12,25,0.48,0.452,2,4,0.5,8,45,53,21,12,4,12,34,86
444,Pascal Siakam,PF,24,TOR,78,77,2493,507,929,0.546,75,207,0.362,432,722,0.598,0.586,232,296,0.784,123,412,535,245,72,52,149,235,1321
445,Jordan Sibert,SG,26,ATL,1,0,4,1,1,1,1,1,1,0,0,,1.5,0,0,,0,0,0,0,0,0,0,0,3
446,Ben Simmons,PG,22,PHI,77,77,2653,527,938,0.562,0,6,0,527,932,0.565,0.562,253,421,0.601,166,522,688,605,108,60,269,206,1307
447,Jonathon Simmons,SG-SF,29,TOT,54,9,1008,120,327,0.367,23,95,0.242,97,232,0.418,0.402,69,93,0.742,26,91,117,115,26,14,64,88,332
447,Jonathon Simmons,SG,29,ORL,41,9,845,104,286,0.364,19,83,0.229,85,203,0.419,0.397,56,72,0.778,23,77,100,95,18,14,56,68,283
447,Jonathon Simmons,SF,29,PHI,13,0,163,16,41,0.39,4,12,0.333,12,29,0.414,0.439,13,21,0.619,3,14,17,20,8,0,8,20,49
448,Kobi Simmons,PG,21,CLE,1,0,2,0,0,,0,0,,0,0,,,0,0,,0,0,0,0,0,0,0,0,0
449,Anfernee Simons,SG,19,POR,19,0,93,15,42,0.357,3,18,0.167,12,24,0.5,0.393,5,10,0.5,0,7,7,4,0,0,9,7,38
450,Marcus Smart,SG,24,BOS,79,59,2180,237,562,0.422,124,341,0.364,113,221,0.511,0.532,104,129,0.806,56,176,232,319,139,28,122,199,702
451,Dennis Smith,PG,21,TOT,51,49,1447,262,615,0.426,62,194,0.32,200,421,0.475,0.476,96,150,0.64,32,120,152,242,66,20,145,127,682
451,Dennis Smith,PG,21,DAL,32,32,908,157,357,0.44,43,125,0.344,114,232,0.491,0.5,57,82,0.695,18,79,97,138,40,11,100,82,414
451,Dennis Smith,PG,21,NYK,19,17,539,105,258,0.407,19,69,0.275,86,189,0.455,0.444,39,68,0.574,14,41,55,104,26,9,45,45,268
452,Ish Smith,PG,30,DET,53,0,1178,186,453,0.411,41,126,0.325,145,327,0.443,0.456,44,57,0.772,23,114,137,191,28,11,60,103,457
453,J.R. Smith,SG,33,CLE,11,4,222,27,79,0.342,12,39,0.308,15,40,0.375,0.418,8,10,0.8,0,18,18,21,11,3,11,19,74
454,Jason Smith,PF-C,32,TOT,20,1,190,21,59,0.356,9,26,0.346,12,33,0.364,0.432,14,16,0.875,16,36,52,14,3,7,13,30,65
454,Jason Smith,C,32,WAS,12,1,130,15,37,0.405,4,10,0.4,11,27,0.407,0.459,10,12,0.833,11,26,37,12,1,5,7,21,44
454,Jason Smith,PF,32,MIL,6,0,40,4,13,0.308,3,9,0.333,1,4,0.25,0.423,2,2,1,3,8,11,1,2,2,5,6,13
454,Jason Smith,C,32,NOP,2,0,20,2,9,0.222,2,7,0.286,0,2,0,0.333,2,2,1,2,2,4,1,0,0,1,3,8
455,Zhaire Smith,SG,19,PHI,3,0,33,2,7,0.286,2,3,0.667,0,4,0,0.429,3,4,0.75,0,4,4,2,2,2,2,5,9
456,Tony Snell,SF,27,MIL,74,12,1304,163,361,0.452,81,204,0.397,82,157,0.522,0.564,37,42,0.881,29,128,157,68,26,18,23,90,444
457,Ray Spalding,PF,21,TOT,12,1,106,20,33,0.606,0,1,0,20,32,0.625,0.606,3,9,0.333,14,23,37,3,5,6,7,16,43
457,Ray Spalding,PF,21,DAL,1,0,1,0,0,,0,0,,0,0,,,0,0,,0,0,0,0,0,0,0,0,0
457,Ray Spalding,PF,21,PHO,11,1,105,20,33,0.606,0,1,0,20,32,0.625,0.606,3,9,0.333,14,23,37,3,5,6,7,16,43
458,Omari Spellman,PF,21,ATL,46,11,805,98,244,0.402,44,128,0.344,54,116,0.466,0.492,32,45,0.711,72,122,194,47,26,25,31,67,272
459,Nik Stauskas,SG,25,TOT,67,0,1003,135,335,0.403,69,187,0.369,66,148,0.446,0.506,57,64,0.891,18,108,126,81,21,7,50,50,396
459,Nik Stauskas,SG,25,POR,44,0,673,96,229,0.419,43,125,0.344,53,104,0.51,0.513,32,36,0.889,10,70,80,62,14,4,40,31,267
459,Nik Stauskas,SG,25,CLE,23,0,330,39,106,0.368,26,62,0.419,13,44,0.295,0.491,25,28,0.893,8,38,46,19,7,3,10,19,129
460,D.J. Stephens,SG,28,MEM,1,0,7,1,2,0.5,0,0,,1,2,0.5,0.5,0,0,,0,0,0,0,1,0,1,0,2
461,Lance Stephenson,SG,28,LAL,68,3,1123,184,432,0.426,73,197,0.371,111,235,0.472,0.51,50,73,0.685,32,183,215,140,41,7,86,111,491
462,Edmond Sumner,PG,23,IND,21,2,178,17,50,0.34,4,20,0.2,13,30,0.433,0.38,6,13,0.462,7,13,20,9,10,5,8,21,44
463,Caleb Swanigan,PF,21,TOT,20,0,160,16,48,0.333,1,6,0.167,15,42,0.357,0.344,6,9,0.667,14,43,57,8,4,0,18,26,39
463,Caleb Swanigan,PF,21,POR,18,0,145,14,44,0.318,1,5,0.2,13,39,0.333,0.33,6,7,0.857,13,39,52,7,4,0,16,22,35
463,Caleb Swanigan,PF,21,SAC,2,0,15,2,4,0.5,0,1,0,2,3,0.667,0.5,0,2,0,1,4,5,1,0,0,2,4,4
464,Jayson Tatum,SF,20,BOS,78,78,2449,466,1034,0.451,116,311,0.373,350,723,0.484,0.507,195,228,0.855,70,406,476,168,84,57,122,168,1243
465,Jeff Teague,PG,30,MIN,42,41,1264,176,416,0.423,35,105,0.333,141,311,0.453,0.465,123,153,0.804,16,90,106,343,43,18,97,90,510
466,Garrett Temple,SG,32,TOT,73,55,2005,206,487,0.423,89,261,0.341,117,226,0.518,0.514,76,103,0.738,27,185,212,104,73,30,70,198,577
466,Garrett Temple,SG,32,MEM,49,49,1530,166,387,0.429,74,210,0.352,92,177,0.52,0.525,57,76,0.75,18,134,152,69,50,25,54,134,463
466,Garrett Temple,SG,32,LAC,24,6,475,40,100,0.4,15,51,0.294,25,49,0.51,0.475,19,27,0.704,9,51,60,35,23,5,16,64,114
467,Milos Teodosic,PG,31,LAC,15,0,150,17,40,0.425,10,27,0.37,7,13,0.538,0.55,4,7,0.571,3,13,16,32,3,1,21,27,48
468,Jared Terrell,SG,23,MIN,11,0,76,8,27,0.296,4,12,0.333,4,15,0.267,0.37,1,2,0.5,1,3,4,7,3,1,8,9,21
469,Emanuel Terry,PF,22,TOT,3,0,23,4,7,0.571,0,0,,4,7,0.571,0.571,2,4,0.5,3,4,7,2,3,0,2,4,10
469,Emanuel Terry,PF,22,PHO,2,0,20,4,6,0.667,0,0,,4,6,0.667,0.667,1,2,0.5,2,4,6,1,3,0,2,4,9
469,Emanuel Terry,PF,22,MIA,1,0,3,0,1,0,0,0,,0,1,0,0,1,2,0.5,1,0,1,1,0,0,0,0,1
470,Daniel Theis,C,26,BOS,64,2,876,142,258,0.55,26,64,0.406,116,194,0.598,0.601,56,76,0.737,85,133,218,66,21,40,33,157,366
471,Isaiah Thomas,SG,29,DEN,11,0,157,30,85,0.353,11,38,0.289,19,47,0.404,0.418,16,23,0.696,5,8,13,20,3,1,17,14,87
472,Khyri Thomas,SG,22,DET,25,0,190,22,66,0.333,10,35,0.286,12,31,0.387,0.409,7,11,0.636,4,16,20,8,7,5,4,21,61
473,Lance Thomas,PF,30,NYK,46,17,783,78,197,0.396,22,79,0.278,56,118,0.475,0.452,27,36,0.75,21,96,117,27,17,7,24,83,205
474,Klay Thompson,SG,28,GSW,76,76,2603,642,1379,0.466,236,589,0.401,406,790,0.514,0.551,129,158,0.816,37,260,297,183,82,46,114,156,1649
475,Tristan Thompson,C,27,CLE,43,40,1198,201,380,0.529,0,0,,201,380,0.529,0.529,68,106,0.642,173,265,438,86,28,16,59,89,470
476,Sindarius Thornwell,SG,24,LAC,62,1,292,17,49,0.347,3,15,0.2,14,34,0.412,0.378,21,30,0.7,5,38,43,17,14,7,19,38,58
477,Anthony Tolliver,PF,33,MIN,62,0,1020,94,244,0.385,77,203,0.379,17,41,0.415,0.543,47,59,0.797,15,154,169,42,14,18,34,86,312
478,Karl-Anthony Towns,C,23,MIN,76,76,2511,670,1296,0.517,142,354,0.401,528,942,0.561,0.572,363,436,0.833,261,686,947,257,65,124,235,288,1845
479,Gary Trent,SG,20,POR,14,0,63,8,31,0.258,4,16,0.25,4,15,0.267,0.323,1,4,0.25,1,8,9,2,0,1,3,3,21
480,Allonzo Trier,SG,23,NYK,64,3,1459,232,518,0.448,52,132,0.394,180,386,0.466,0.498,179,223,0.803,31,166,197,119,28,14,116,117,695
481,P.J. Tucker,PF,33,HOU,80,80,2750,202,507,0.398,142,375,0.379,60,132,0.455,0.538,39,57,0.684,117,354,471,94,130,36,62,246,585
482,Evan Turner,PG,30,POR,71,2,1568,201,434,0.463,11,52,0.212,190,382,0.497,0.476,67,96,0.698,36,283,319,274,31,16,111,109,480
483,Myles Turner,C,22,IND,73,73,2101,378,775,0.488,74,193,0.383,304,582,0.522,0.535,148,201,0.736,101,426,527,115,59,196,100,195,978
484,Ekpe Udoh,C,31,UTA,48,0,278,44,64,0.688,0,0,,44,64,0.688,0.688,14,21,0.667,23,52,75,22,9,26,11,33,102
485,Tyler Ulis,PG,23,CHI,1,0,1,0,0,,0,0,,0,0,,,0,0,,0,0,0,0,0,0,0,0,0
486,Jonas Valanciunas,C,26,TOT,49,27,1091,301,538,0.559,14,48,0.292,287,490,0.586,0.572,147,185,0.795,106,313,419,70,19,53,90,146,763
486,Jonas Valanciunas,C,26,TOR,30,10,564,149,259,0.575,9,30,0.3,140,229,0.611,0.593,77,94,0.819,54,162,216,29,13,23,39,82,384
486,Jonas Valanciunas,C,26,MEM,19,17,527,152,279,0.545,5,18,0.278,147,261,0.563,0.554,70,91,0.769,52,151,203,41,6,30,51,64,379
487,Jarred Vanderbilt,PF,19,DEN,15,0,54,8,17,0.471,0,1,0,8,16,0.5,0.471,4,8,0.5,6,16,22,3,4,1,4,5,20
488,Fred VanVleet,PG,24,TOR,62,27,1711,239,580,0.412,109,285,0.382,130,295,0.441,0.506,95,113,0.841,21,143,164,298,53,20,80,109,682
489,Noah Vonleh,PF,23,NYK,68,57,1722,207,440,0.47,46,137,0.336,161,303,0.531,0.523,111,156,0.712,113,415,528,129,46,51,88,174,571
490,Nikola Vucevic,C,28,ORL,79,79,2476,689,1332,0.517,83,227,0.366,606,1105,0.548,0.548,179,227,0.789,219,729,948,303,80,87,156,154,1640
491,Dwyane Wade,SG,37,MIA,69,0,1782,389,895,0.435,75,232,0.323,314,663,0.474,0.477,154,221,0.697,66,202,268,283,59,36,159,113,1007
492,Moritz Wagner,C,21,LAL,41,5,418,65,157,0.414,22,72,0.306,43,85,0.506,0.484,42,51,0.824,16,64,80,24,11,12,38,52,194
493,Dion Waiters,SG,27,MIA,41,27,1079,189,452,0.418,102,272,0.375,87,180,0.483,0.531,22,44,0.5,7,102,109,116,29,8,63,69,502
494,Kemba Walker,PG,28,CHO,79,79,2754,695,1612,0.431,249,701,0.355,446,911,0.49,0.508,366,434,0.843,51,297,348,465,101,32,206,126,2005
495,Lonnie Walker,SG,20,SAS,15,0,102,13,42,0.31,5,13,0.385,8,29,0.276,0.369,7,8,0.875,0,15,15,7,6,2,4,7,38
496,John Wall,PG,28,WAS,32,32,1104,245,552,0.444,51,169,0.302,194,383,0.507,0.49,122,175,0.697,15,101,116,279,49,29,121,71,663
497,Tyrone Wallace,PG,24,LAC,60,0,603,86,208,0.413,4,19,0.211,82,189,0.434,0.423,30,55,0.545,20,77,97,40,21,7,33,82,206
498,Taurean Waller-Prince,SF,24,ATL,53,45,1492,250,561,0.446,116,302,0.384,134,259,0.517,0.549,93,113,0.823,21,170,191,114,53,18,98,134,709
499,Brad Wanamaker,PG,29,BOS,34,0,308,43,89,0.483,16,34,0.471,27,55,0.491,0.573,19,21,0.905,3,32,35,48,11,2,18,31,121
500,T.J. Warren,SF,25,PHO,43,36,1360,297,611,0.486,77,180,0.428,220,431,0.51,0.549,101,124,0.815,31,143,174,64,51,29,52,119,772
501,Julian Washburn,SF,27,MEM,15,3,208,11,40,0.275,4,21,0.19,7,19,0.368,0.325,3,4,0.75,7,26,33,14,10,2,6,12,29
502,Yuta Watanabe,SF,24,MEM,14,0,155,13,43,0.302,2,13,0.154,11,30,0.367,0.326,7,10,0.7,2,25,27,8,4,1,6,9,35
503,Thomas Welsh,C,22,DEN,11,0,36,7,13,0.538,3,7,0.429,4,6,0.667,0.654,1,2,0.5,0,4,4,5,0,0,1,3,18
504,Russell Westbrook,PG,30,OKC,70,70,2518,602,1418,0.425,112,392,0.286,490,1026,0.478,0.464,288,439,0.656,106,668,774,742,140,32,314,235,1604
505,Derrick White,PG,24,SAS,65,53,1678,251,527,0.476,46,138,0.333,205,389,0.527,0.52,93,121,0.769,34,203,237,257,66,45,95,140,641
506,Okaro White,PF,26,WAS,3,0,6,0,2,0,0,2,0,0,0,,0,0,0,,1,1,2,0,0,0,0,0,0
507,Hassan Whiteside,C,29,MIA,70,53,1639,374,663,0.564,2,16,0.125,372,647,0.575,0.566,108,241,0.448,254,545,799,56,44,131,96,187,858
508,Andrew Wiggins,SF,23,MIN,70,70,2444,471,1157,0.407,110,331,0.332,361,826,0.437,0.455,204,290,0.703,80,259,339,173,68,46,133,148,1256
509,Alan Williams,PF,26,BRK,4,0,22,6,10,0.6,0,1,0,6,9,0.667,0.6,2,4,0.5,4,13,17,3,1,0,1,2,14
510,C.J. Williams,SG,28,MIN,13,0,92,12,27,0.444,2,12,0.167,10,15,0.667,0.481,0,0,,1,4,5,11,3,0,4,13,26
511,Johnathan Williams,C,23,LAL,22,0,321,56,95,0.589,0,2,0,56,93,0.602,0.589,19,37,0.514,39,42,81,10,6,7,13,57,131
512,Kenrich Williams,SF,24,NOP,44,27,1017,99,261,0.379,48,145,0.331,51,116,0.44,0.471,13,19,0.684,52,155,207,72,40,17,33,91,259
513,Lou Williams,SG,32,LAC,73,0,1942,475,1109,0.428,103,287,0.359,372,822,0.453,0.475,417,476,0.876,38,174,212,392,54,9,172,77,1470
514,Marvin Williams,PF,32,CHO,75,75,2133,275,652,0.422,140,382,0.366,135,270,0.5,0.529,66,86,0.767,76,331,407,92,71,61,47,156,756
515,Robert Williams,C,21,BOS,31,1,254,35,48,0.729,0,0,,35,48,0.729,0.729,9,15,0.6,24,46,70,6,8,37,9,30,79
516,Troy Williams,SF,24,SAC,19,0,298,42,91,0.462,14,42,0.333,28,49,0.571,0.538,9,15,0.6,10,47,57,11,10,8,9,34,107
517,D.J. Wilson,PF,22,MIL,45,1,791,91,220,0.414,41,112,0.366,50,108,0.463,0.507,24,44,0.545,40,151,191,46,17,19,28,77,247
518,Justise Winslow,SF,22,MIA,63,49,1874,309,713,0.433,90,241,0.373,219,472,0.464,0.496,83,132,0.629,60,280,340,270,66,18,136,166,791
519,Christian Wood,PF,23,TOT,19,0,193,46,82,0.561,5,16,0.313,41,66,0.621,0.591,35,49,0.714,12,52,64,8,7,9,13,13,132
519,Christian Wood,PF,23,MIL,13,0,62,12,25,0.48,3,5,0.6,9,20,0.45,0.54,10,15,0.667,4,16,20,2,0,0,3,3,37
519,Christian Wood,PF,23,NOP,6,0,131,34,57,0.596,2,11,0.182,32,46,0.696,0.614,25,34,0.735,8,36,44,6,7,9,10,10,95
520,Delon Wright,PG,26,TOT,72,10,1583,227,524,0.433,46,156,0.295,181,368,0.492,0.477,105,134,0.784,64,169,233,223,84,29,70,96,605
520,Delon Wright,PG,26,TOR,49,2,897,127,293,0.433,30,90,0.333,97,203,0.478,0.485,53,61,0.869,39,86,125,110,46,15,37,53,337
520,Delon Wright,PG,26,MEM,23,8,686,100,231,0.433,16,66,0.242,84,165,0.509,0.468,52,73,0.712,25,83,108,113,38,14,33,43,268
521,Guerschon Yabusele,PF,23,BOS,40,0,226,30,67,0.448,6,23,0.261,24,44,0.545,0.493,15,20,0.75,22,26,48,14,8,7,15,31,81
522,Nick Young,SG,33,DEN,4,0,37,3,9,0.333,3,8,0.375,0,1,0,0.5,0,0,,0,1,1,2,0,1,2,4,9
523,Thaddeus Young,PF,30,IND,80,80,2463,435,831,0.523,51,146,0.349,384,685,0.561,0.554,87,134,0.649,190,331,521,200,122,36,119,191,1008
524,Trae Young,PG,20,ATL,80,80,2470,519,1238,0.419,155,475,0.326,364,763,0.477,0.482,333,403,0.826,62,234,296,642,70,15,302,140,1526
525,Cody Zeller,C,26,CHO,49,47,1243,190,345,0.551,6,22,0.273,184,323,0.57,0.559,111,141,0.787,110,223,333,102,38,41,62,164,497
526,Tyler Zeller,C,29,TOT,3,0,29,3,8,0.375,0,1,0,3,7,0.429,0.375,4,4,1,4,5,9,1,1,0,0,7,10
526,Tyler Zeller,C,29,ATL,2,0,11,0,2,0,0,1,0,0,1,0,0,0,0,,2,4,6,1,0,0,0,4,0
526,Tyler Zeller,F-C,29,MEM,1,0,18,3,6,0.5,0,0,,3,6,0.5,0.5,4,4,1,2,1,3,0,1,0,0,3,10
527,Ante Zizic,C,22,CLE,57,24,1044,175,319,0.549,0,0,,175,319,0.549,0.549,89,127,0.701,102,208,310,50,13,22,58,111,439
528,Ivica Zubac,C,21,TOT,57,36,989,200,358,0.559,0,0,,200,358,0.559,0.559,96,120,0.8,108,235,343,60,14,48,67,135,496
528,Ivica Zubac,C,21,LAL,33,12,516,112,193,0.58,0,0,,112,193,0.58,0.58,57,66,0.864,54,108,162,25,4,27,33,73,281
528,Ivica Zubac,C,21,LAC,24,24,473,88,165,0.533,0,0,,88,165,0.533,0.533,39,54,0.722,54,127,181,35,10,21,34,62,215
